code,201712,201812,201912,202012,change
65000010001,1645,1649,1660,1696,47
65000010002,1567,1564,1546,1518,-46
65000010003,831,840,940,996,156
65000010004,1147,1136,1238,1281,145
65000010005,1884,1904,1981,2009,105
65000010006,5621,5547,5470,5311,-236
65000010007,3337,3314,3308,3232,-82
65000010008,9114,9350,9401,9815,465
65000010009,4462,4408,4371,4315,-93
65000010010,4500,4521,4572,5255,734
65000010011,5376,5349,5330,5312,-37
65000010012,2952,2897,2882,2875,-22
65000010013,2777,2823,2815,2777,-46
65000010014,3801,3799,3789,3774,-25
65000010015,3049,3063,3022,3041,-22
65000010016,4172,4132,4158,4084,-48
65000010017,5039,4962,4941,4844,-118
65000010018,2764,2735,2717,2673,-62
65000010019,3714,3706,3634,3597,-109
65000010020,4428,4391,4390,4397,6
65000010021,4066,4005,3957,4029,24
65000010022,4631,4613,4610,4622,9
65000010023,4133,4064,4023,4055,-9
65000010024,4261,4275,4376,4442,167
65000010025,2752,2845,2962,3016,171
65000010026,3187,3264,3262,3283,19
65000010027,2160,2150,2139,2138,-12
65000010028,7809,7889,8024,7955,66
65000010029,4963,5078,5122,5294,216
65000010030,5675,5608,5604,5505,-103
65000010031,6266,6228,6110,6299,71
65000010032,3792,3789,3823,3812,23
65000010033,4928,5030,5263,5548,518
65000010034,3013,2909,2928,2930,21
65000010035,8125,8105,8226,8366,261
65000010036,3887,3914,3872,3843,-71
65000010037,7620,7616,7626,7465,-151
65000010038,3080,3038,3012,3038,0
65000010039,4947,4893,4866,4865,-28
65000010040,3506,3475,3470,3441,-34
65000010041,4250,4299,4582,4844,545
65000010042,5282,5182,5147,5083,-99
65000010043,3845,3792,3732,3694,-98
65000010044,11003,11010,11119,11071,61
65000010045,2588,2546,2542,2519,-27
65000010046,4177,4171,4172,4086,-85
65000010047,3108,3073,3062,3030,-43
65000010048,6258,6201,6244,6258,57
65000010049,1378,1361,1349,1400,39
65000010050,6295,6237,6157,6129,-108
65000010051,4594,4557,4529,4430,-127
65000010052,4381,4347,4329,4295,-52
65000010053,3458,3474,3463,3440,-34
65000010054,6461,6424,6430,6368,-56
65000010055,2943,2979,2978,2983,4
65000010056,3422,3415,3413,3346,-69
65000010057,8534,8528,8500,8357,-171
65000010058,2993,2962,2948,2971,9
65000010059,5649,5648,5652,5697,49
65000010060,3111,3060,3058,3014,-46
65000010061,4694,4766,4830,4791,25
65000010062,3650,3621,3599,3736,115
65000010063,4366,4418,4437,4435,17
65000010064,3788,3765,3785,3758,-7
65000010065,9371,9313,9389,9420,107
65000010066,3994,3992,4027,4074,82
65000010067,2845,2878,2904,2862,-16
65000010068,4931,4866,4887,4849,-17
65000010069,5021,5022,5001,4974,-48
65000010070,5051,5088,5239,5235,147
65000010071,4133,4126,4099,4136,10
65000010072,5164,5143,5141,5132,-11
65000010073,3813,3785,3829,3792,7
65000010074,5399,5353,5286,5179,-174
65000010075,3582,3516,3578,3524,8
65000010076,3733,3715,3698,3656,-59
65000010077,3863,3921,3942,3883,-38
65000010078,7092,7083,7105,7021,-62
65000010079,4929,4829,4838,4764,-65
65000010080,9100,9015,8923,8916,-99
65000010081,3289,3286,3243,3164,-122
65000010082,4156,4188,4226,4280,92
65000010083,4326,4282,4266,4206,-76
65000010084,4269,4360,4376,4324,-36
65000010085,2802,2734,2687,2650,-84
65000010086,7395,7398,7438,7296,-102
65000010087,7517,7746,7899,8043,297
65000010088,4429,4397,4453,4462,65
65000010089,4198,3994,4033,3968,-26
65000010090,5548,5530,5503,5458,-72
65000010091,4381,4371,4356,4337,-34
65000010092,5196,6737,7018,7165,428
65000010093,1100,1103,1034,1016,-87
65000010094,4195,4084,4092,4058,-26
65000010095,2635,6539,7272,7471,932
65000010096,5627,5533,5483,5413,-120
65000010097,2972,2959,2927,2886,-73
65000010098,10492,10438,10349,10355,-83
65000010099,6294,6235,6219,6176,-59
65000010100,3749,3734,3721,3725,-9
65000010101,2659,2622,2615,2606,-16
65000010102,4556,4512,4502,4431,-81
65000010103,3245,3207,3177,3096,-111
65000010104,3531,3489,3531,3527,38
65000010105,3754,3713,3700,3603,-110
65000010106,3043,3020,3006,2928,-92
65000010107,2395,2328,2327,2340,12
65000010108,3216,3184,3125,3072,-112
65000010109,2366,2334,2336,2376,42
65000010110,3950,3889,3863,3847,-42
65000010111,2199,2179,2125,2105,-74
65000010112,4575,4586,4549,4466,-120
65000010113,6948,7081,7257,7395,314
65000010114,2670,2640,2657,2658,18
65000010115,2213,2185,2199,2247,62
65000010116,2899,2828,2785,2748,-80
65000010117,3545,3495,3496,3476,-19
65000010118,2423,2368,2300,2300,-68
65000010119,4046,4053,4051,4050,-3
65000010120,3428,3383,3768,3975,592
65000010121,4451,4451,4507,4554,103
65000010122,2751,2723,2683,2653,-70
65000010123,4355,4301,4230,4205,-96
65000010124,15179,15027,14994,14990,-37
65000010125,3942,3844,3857,3834,-10
65000010126,1341,1293,1279,1279,-14
65000020001,5521,5486,5533,5483,-3
65000020002,1684,1665,1648,1656,-9
65000020003,2405,2393,2348,2640,247
65000020004,1014,957,967,988,31
65000020005,4039,4039,4072,4074,35
65000020006,394,389,377,376,-13
65000020007,6580,6530,6574,6755,225
65000020008,5767,5792,5799,5804,12
65000020009,3688,3686,3680,3584,-102
65000020010,9668,9699,9843,9909,210
65000020011,2146,2145,2160,2190,45
65000020012,3820,3794,3900,3955,161
65000020013,4603,4534,4468,4447,-87
65000020014,6519,6444,6453,6403,-41
65000020015,4245,4250,4188,4176,-74
65000020016,3692,3614,3563,3539,-75
65000020017,6700,6613,6637,6569,-44
65000020018,6505,6410,6481,6411,1
65000020019,3580,3538,3567,3528,-10
65000020020,7892,7875,7863,7787,-88
65000020021,2605,2576,2591,2719,143
65000020022,1509,1481,1507,1493,12
65000020023,1822,1819,1851,1804,-15
65000020024,2373,2357,2346,2339,-18
65000020025,2098,2033,2027,2004,-29
65000020026,1405,1438,1441,1413,-25
65000020027,1470,1464,1443,1430,-34
65000020028,2036,2050,2044,2048,-2
65000020029,1354,1311,1317,1297,-14
65000020030,1584,1554,1550,1533,-21
65000020031,1737,1742,1745,1715,-27
65000020032,2051,2093,2044,2008,-85
65000020033,1814,1881,1884,1873,-8
65000020034,1323,1289,1282,1293,4
65000020035,1474,1481,1489,1468,-13
65000020036,1587,1560,1549,1540,-20
65000020037,1133,1130,1190,1218,88
65000020038,2322,2325,2362,2316,-9
65000020039,3953,3979,4045,4086,107
65000020040,1362,1387,1374,1406,19
65000020041,2849,2857,2852,2829,-28
65000020042,2923,2945,2933,2935,-10
65000020043,2839,2858,2799,2742,-116
65000020044,3850,3767,3715,3707,-60
65000020045,4533,4439,4454,4461,22
65000020046,1531,1510,1497,1529,19
65000020047,1208,1225,1222,1186,-39
65000020048,1924,1901,1894,1879,-22
65000020049,2052,2048,2056,2050,2
65000020050,1893,1870,1857,1865,-5
65000020051,2481,2464,2386,2347,-117
65000020052,1911,1898,1878,1900,2
65000020053,998,1001,999,971,-30
65000020054,1551,1542,1531,1513,-29
65000020055,1934,1906,1910,1868,-38
65000020056,2315,2312,2304,2246,-66
65000020057,2073,2098,2188,2277,179
65000020058,910,913,920,914,1
65000020059,1558,1552,1545,1542,-10
65000020060,856,882,882,884,2
65000020061,2570,2564,2549,2526,-38
65000020062,2132,2107,2122,2090,-17
65000020063,2349,2346,2317,2273,-73
65000020064,1626,1618,1598,1586,-32
65000020065,1246,1239,1254,1235,-4
65000020066,2123,2069,2040,2034,-35
65000020067,2454,2431,2414,2391,-40
65000020068,3435,3476,3448,3416,-60
65000020069,1966,1956,1955,1946,-10
65000020070,1453,1409,1371,1345,-64
65000020071,1843,1816,1792,1787,-29
65000020072,2713,2752,2756,2738,-14
65000020073,3178,3163,3100,3075,-88
65000020074,2060,2055,2108,2075,20
65000020075,2192,2164,2112,2113,-51
65000020076,4829,4818,4813,4811,-7
65000020077,3941,3920,3927,3895,-25
65000020078,5972,5928,6013,6007,79
65000020079,2337,2308,2330,2334,26
65000020080,1928,1864,1869,1860,-4
65000020081,2538,2529,2537,2486,-43
65000020082,4190,4144,4092,4022,-122
65000020083,3888,3860,3790,3754,-106
65000020084,3157,3087,3008,3039,-48
65000020085,3264,3251,3193,3152,-99
65000020086,3964,3932,3905,3845,-87
65000020087,5306,5231,5239,5176,-55
65000020088,3551,3537,3532,3460,-77
65000020089,5744,5670,5642,5536,-134
65000020090,5883,5749,5719,5664,-85
65000020091,4451,4370,4309,4343,-27
65000020092,2640,2633,2639,2575,-58
65000020093,8445,8673,8740,8933,260
65000020094,4829,4860,4851,4830,-30
65000020095,4431,4393,4360,4344,-49
65000020096,4083,4009,4071,4017,8
65000020097,3332,3337,3344,3296,-41
65000020098,2315,2273,2297,2296,23
65000020099,2385,2380,2343,2311,-69
65000020100,2261,2220,2316,2309,89
65000020101,3638,3612,3561,3485,-127
65000020102,2680,2615,2604,2618,3
65000020103,4975,4902,5092,5202,300
65000020104,5492,5487,5471,5429,-58
65000020105,6517,6658,6823,6870,212
65000020106,3393,3417,3462,3467,50
65000020107,2175,2174,2153,2185,11
65000020108,7843,8185,8462,8682,497
65000020109,1804,1797,1897,1937,140
65000020110,4864,4790,4725,4663,-127
65000020111,4135,4186,4280,4279,93
65000020112,3174,3101,3078,3018,-83
65000020113,6155,6162,6133,6108,-54
65000020114,5533,5468,5397,5334,-134
65000020115,6342,6326,6303,6235,-91
65000020116,3585,3565,3573,3499,-66
65000020117,3937,3926,3899,3873,-53
65000020118,4402,4336,4429,4478,142
65000020119,4173,4187,4155,4119,-68
65000030001,5843,6120,6603,7203,1083
65000030002,9569,9500,9369,9397,-103
65000030003,4497,4507,4486,4444,-63
65000030004,4437,4369,4305,4173,-196
65000030005,4227,4197,4129,4048,-149
65000030006,3714,3661,3623,3567,-94
65000030007,2479,2444,2479,2461,17
65000030008,6683,6627,6676,6611,-16
65000030009,6435,6321,6227,6222,-99
65000030010,3862,3809,3909,3872,63
65000030011,3746,3782,3882,3961,179
65000030012,4588,4582,4573,4523,-59
65000030013,4341,4299,4219,4182,-117
65000030014,4327,4351,4399,4345,-6
65000030015,4576,4558,4567,4528,-30
65000030016,5261,5173,5190,5138,-35
65000030017,5745,5777,5772,5705,-72
65000030018,3820,3776,3726,3696,-80
65000030019,5010,5066,5030,5052,-14
65000030020,3700,3690,3699,3690,0
65000030021,3179,3177,3211,3217,40
65000030022,6056,6080,6094,6002,-78
65000030023,4464,4420,4390,4398,-22
65000030024,3629,3590,3588,3571,-19
65000030025,8500,8512,8434,8279,-233
65000030026,5459,5347,5293,5225,-122
65000030027,4695,4679,4650,4623,-56
65000030028,3654,3619,3629,3553,-66
65000030029,4872,4815,4846,4846,31
65000030030,6509,6533,6492,6505,-28
65000030031,5158,5160,5198,5161,1
65000030032,4587,4655,4832,4886,231
65000030033,3407,3526,3521,3514,-12
65000030034,3154,3109,3049,2970,-139
65000030035,7591,7578,7581,7505,-73
65000030036,4363,4395,4396,4385,-10
65000030037,5249,5245,5240,5204,-41
65000030038,5047,4938,4919,4846,-92
65000030039,4170,4290,4398,4381,91
65000030040,3270,3278,3286,3214,-64
65000030041,357,349,336,328,-21
65000030042,5352,5248,5169,5131,-117
65000030043,2466,2419,2434,2445,26
65000030044,7481,7452,7561,7563,111
65000030045,5381,5303,5280,5204,-99
65000030046,4636,4578,4574,4555,-23
65000030047,5554,5502,5526,5500,-2
65000030048,3676,3647,3619,3600,-47
65000030049,5690,5819,5818,5858,39
65000030050,4840,4771,4854,4966,195
65000030051,3517,3645,3797,3867,222
65000030052,5835,5781,5775,5702,-79
65000030053,2370,2325,2342,2329,4
65000030054,832,819,832,831,12
65000030055,8547,8509,8467,8473,-36
65000030056,2607,2569,2565,2514,-55
65000030057,6939,6992,7171,7098,106
65000030058,2900,2919,2921,2922,3
65000030059,5497,5433,5383,5323,-110
65000030060,4224,4164,4137,4105,-59
65000030061,5179,5197,5223,5224,27
65000030062,4762,4772,4728,4748,-24
65000030063,2522,2494,2493,2519,25
65000030064,4721,4668,4727,4673,5
65000030065,3366,3293,3248,3265,-28
65000030066,5187,5189,5204,5099,-90
65000030067,4688,4719,4722,4698,-21
65000030068,4295,4230,4252,4217,-13
65000030069,4073,4016,3991,3934,-82
65000030070,4810,4805,4764,4758,-47
65000030071,4132,4113,4157,4119,6
65000030072,3856,3845,3853,3838,-7
65000030073,6927,6900,6885,6804,-96
65000030074,1872,1914,1906,1905,-9
65000030075,4477,4458,4470,4362,-96
65000030076,2743,2761,2766,2757,-4
65000030077,2516,2540,2537,2515,-25
65000030078,3281,3201,3194,3134,-67
65000030079,2196,2234,2193,2156,-78
65000030080,4455,4393,4348,4307,-86
65000030081,7154,7189,7241,7145,-44
65000030082,3132,3110,3075,3050,-60
65000030083,2894,2898,2853,2837,-61
65000030084,4441,4500,4685,4954,454
65000030085,4519,4515,4454,4391,-124
65000030086,4101,4041,4026,3989,-52
65000030087,2883,2897,2884,2805,-92
65000030088,3541,3582,3627,3678,96
65000030089,4558,4561,4550,4517,-44
65000030090,3491,3454,3413,3341,-113
65000030091,3462,3486,3443,3443,-43
65000030092,3699,3659,3630,3603,-56
65000030093,3083,3053,3056,3012,-41
65000040001,3560,3522,3482,3454,-68
65000040002,2879,2909,2875,2870,-39
65000040003,4938,4921,5203,5015,94
65000040004,3160,3123,3116,3025,-98
65000040005,2767,2757,2767,2738,-19
65000040006,3604,3540,3520,3436,-104
65000040007,2875,2863,2851,2781,-82
65000040008,3048,2978,3004,2960,-18
65000040009,1041,1000,998,992,-8
65000040010,867,851,837,803,-48
65000040011,5006,4964,4916,4916,-48
65000040012,3938,4000,4102,4192,192
65000040013,7598,7512,7500,7363,-149
65000040014,5332,5274,5170,5149,-125
65000040015,4278,4301,4297,4261,-40
65000040016,4910,4929,4915,4870,-59
65000040017,4782,4718,4698,4685,-33
65000040018,3076,3146,3182,3225,79
65000040019,1304,1298,1277,1272,-26
65000040020,4182,4098,4064,4032,-66
65000040021,3062,3011,2991,2962,-49
65000040022,2050,2019,2004,1925,-94
65000040023,3829,3826,3808,3760,-66
65000040024,4120,4096,4088,4060,-36
65000040025,4078,4046,3980,3911,-135
65000040026,4213,4165,4165,4078,-87
65000040027,3065,3032,3059,3034,2
65000040028,3418,3465,3512,3476,11
65000040029,2564,2540,2565,2535,-5
65000040030,4807,4749,4769,4750,1
65000040031,5063,5029,5000,4938,-91
65000040032,2707,2685,2695,2676,-9
65000040033,5062,5049,4970,4863,-186
65000040034,4274,4271,4278,4263,-8
65000040035,5039,5001,4979,4829,-172
65000040036,1785,1775,1756,1801,26
65000040037,2442,2418,2424,2415,-3
65000040038,5401,5350,5350,5319,-31
65000040039,4464,4406,4394,4363,-43
65000040040,3536,3532,3505,3443,-89
65000040041,879,870,752,841,-29
65000040042,995,973,783,983,10
65000040043,2172,2163,2193,2171,8
65000040044,5100,5047,5078,5006,-41
65000040045,2312,2281,2301,2271,-10
65000040046,4169,4204,4197,4496,292
65000040047,5196,5140,5117,5060,-80
65000040048,3353,3282,3268,3299,17
65000040049,4286,4240,4207,4196,-44
65000040050,2824,2826,2809,2790,-36
65000040051,3686,3654,3607,3558,-96
65000040052,1251,1245,1219,1222,-23
65000040053,2318,2312,2297,2223,-89
65000040054,3342,3300,3305,3305,5
65000040055,3880,3856,3895,3847,-9
65000040056,4292,4302,4314,4284,-18
65000040057,2717,2695,2691,2661,-34
65000040058,1933,1946,1949,2003,57
65000040059,3255,3196,3150,3088,-108
65000040060,3239,3210,3177,3184,-26
65000040061,2561,2546,2485,2485,-61
65000040062,10701,10641,10735,10951,310
65000050001,5682,5661,5598,5506,-155
65000050002,8476,8859,9196,9756,897
65000050003,1616,1583,1553,1542,-41
65000050004,4742,4747,4746,4698,-49
65000050005,4603,4734,4952,5337,603
65000050006,3924,3888,3887,3852,-36
65000050007,5009,4962,4954,5232,270
65000050008,4838,4768,4761,4710,-58
65000050009,7351,7294,7287,7279,-15
65000050010,2287,2279,2264,2265,-14
65000050011,6270,6249,6249,6308,59
65000050012,3274,3228,3225,3182,-46
65000050013,3668,3636,3558,3486,-150
65000050014,4851,4767,4747,4677,-90
65000050015,11993,12353,12746,13118,765
65000050016,4914,4969,5375,5635,666
65000050017,4752,4706,4737,4623,-83
65000050018,6245,6166,6177,6126,-40
65000050019,1907,1919,1921,1866,-53
65000050020,2295,2287,2295,2252,-35
65000050021,7548,7476,7409,7333,-143
65000050022,1919,1899,1879,1838,-61
65000050023,6812,6838,6802,6751,-87
65000050024,2453,2457,2397,2373,-84
65000050025,5700,5678,5605,5585,-93
65000050026,2449,2410,2172,2040,-370
65000050027,5510,5480,5423,5359,-121
65000050028,2821,2792,2778,2722,-70
65000050029,2740,2719,2746,2700,-19
65000050030,5809,5734,5758,5629,-105
65000050031,5400,5308,5283,5177,-131
65000050032,6352,6367,6348,6323,-44
65000050033,4986,5035,5007,4960,-75
65000050034,3952,3899,3843,3784,-115
65000050035,3135,3076,3082,3080,4
65000050036,3695,3705,3835,4001,296
65000050037,4173,4157,4153,4079,-78
65000050038,8004,7921,7841,7717,-204
65000050039,4473,4472,4476,4420,-52
65000050040,2285,2250,2232,2220,-30
65000050041,4851,4865,4783,4762,-103
65000050042,2846,2840,2788,2720,-120
65000050043,9087,9197,9381,9389,192
65000050044,5073,5094,5196,5242,148
65000050045,5745,5683,5649,5579,-104
65000050046,4804,4817,4768,4813,-4
65000050047,4567,4547,4490,4393,-154
65000050048,11625,11854,12066,12327,473
65000050049,2631,2608,2603,2541,-67
65000050050,9597,10012,10418,10793,781
65000050051,3036,3058,3057,3030,-28
65000050052,4890,5080,5258,5393,313
65000050053,10983,11497,12359,13264,1767
65000050054,9324,9314,9285,9246,-68
65000050055,4900,4888,4954,4852,-36
65000050056,2596,2543,2531,2533,-10
65000050057,3911,3842,3794,3762,-80
65000050058,3786,3784,3708,3669,-115
65000050059,5122,5088,5122,5157,69
65000050060,5323,5270,5267,5158,-112
65000050061,3884,3882,3806,3775,-107
65000050062,6476,6447,6378,6279,-168
65000050063,3817,3826,3818,3772,-54
65000050064,6743,7213,7809,8282,1069
65000050065,3655,3615,3592,3565,-50
65000050066,3888,3851,3862,3843,-8
65000050067,2536,2518,2459,2418,-100
65000050068,2646,2671,2630,2633,-38
65000050069,3132,3086,3121,3141,55
65000050070,6960,6932,6926,6913,-19
65000050071,5355,5315,5257,5299,-16
65000050072,6071,6161,6110,6163,2
65000050073,4031,3991,4000,3970,-21
65000050074,4704,4635,4577,4531,-104
65000050075,9523,9471,9564,9847,376
65000050076,11924,12033,12407,12817,784
65000050077,2633,2595,2602,2620,25
65000050078,3932,3959,3947,3909,-50
65000050079,2358,2318,2315,2276,-42
65000050080,2603,2603,2568,2572,-31
65000050081,3955,3911,3881,3901,-10
65000050082,4218,4187,4171,4163,-24
65000050083,4867,4903,4895,4853,-50
65000050084,3003,3022,3004,2947,-75
65000060001,3411,3400,3314,3215,-185
65000060002,4164,4000,4030,4037,37
65000060003,3845,3857,3855,3777,-80
65000060004,4106,4048,3993,3902,-146
65000060005,5687,5587,5571,5543,-44
65000060006,5397,5393,5458,5500,107
65000060007,5528,5514,5491,5503,-11
65000060008,6348,6504,6626,6628,124
65000060009,2841,2826,2783,2804,-22
65000060010,2727,2740,2730,2708,-32
65000060011,3255,3223,3225,3155,-68
65000060012,1769,1778,1773,1742,-36
65000060013,3383,3451,3461,3439,-12
65000060014,9393,9370,9500,9505,135
65000060015,5396,5365,5347,5319,-46
65000060016,12248,12683,13238,13727,1044
65000060017,6540,6494,6438,6369,-125
65000060018,6038,6029,5963,5882,-147
65000060019,6105,6034,6025,5974,-60
65000060020,6207,6183,6168,6110,-73
65000060021,1074,1069,1072,1074,5
65000060022,5422,5405,5415,5390,-15
65000060023,5258,5312,5325,5377,65
65000060024,868,855,838,822,-33
65000060025,3253,3245,3175,3185,-60
65000060026,2566,2507,2506,2509,2
65000060027,1763,1741,1772,1793,52
65000060028,1388,1410,1421,1418,8
65000060029,1321,1345,1330,1314,-31
65000060030,5555,5549,5527,5546,-3
65000060031,1847,1833,1838,1833,0
65000060032,2151,2175,2176,2350,175
65000060033,2701,2658,2615,2625,-33
65000060034,1790,1777,1797,1805,28
65000060035,878,849,851,864,15
65000060036,2503,2526,2549,2526,0
65000060037,5387,5329,5271,5210,-119
65000060038,6040,5977,5943,5915,-62
65000060039,2790,2790,2823,2793,3
65000060040,8919,9168,9263,9275,107
65000060041,7517,7689,7859,7930,241
65000060042,6642,6533,6430,6430,-103
65000060043,2537,2525,2518,2532,7
65000060044,6577,6414,6365,6260,-154
65000060045,4510,4480,4517,4476,-4
65000060046,2101,2080,2073,2080,0
65000060047,4102,4024,4008,3922,-102
65000060048,3377,3358,3337,3273,-85
65000060049,4092,4049,4012,3945,-104
65000060050,3657,3661,3798,3825,164
65000060051,4235,4286,4304,4297,11
65000060052,4819,4791,4747,4788,-3
65000060053,957,965,954,1300,335
65000060054,5888,5901,6011,6008,107
65000060055,3648,3587,3615,3582,-5
65000060056,7821,7942,8112,8264,322
65000060057,4926,4903,4872,4875,-28
65000060058,7445,7420,7417,7438,18
65000060059,3969,3993,3935,3817,-176
65000060060,10707,10967,11256,11395,428
65000060061,3201,3195,3194,3154,-41
65000060062,3493,3421,3388,3325,-96
65000060063,2847,2796,2786,2792,-4
65000060064,5615,5611,5629,5650,39
65000060065,2576,2596,2604,2589,-7
65000060066,4385,4383,4361,4309,-74
65000060067,5937,5941,5932,5873,-68
65000060068,3924,3989,4079,4102,113
65000060069,2722,2732,2836,2838,106
65000070001,4352,4342,4311,4249,-93
65000070002,4303,4254,4250,4203,-51
65000070003,5188,5148,5093,4966,-182
65000070004,3830,3823,3849,3850,27
65000070005,6751,6687,6609,6467,-220
65000070006,5147,5034,5068,5130,96
65000070007,5372,5302,5242,5183,-119
65000070008,3800,3769,3766,3725,-44
65000070009,5432,5441,5445,5371,-70
65000070010,4382,4360,4318,4305,-55
65000070011,3587,3625,3603,3575,-50
65000070012,1797,1780,1788,1769,-11
65000070013,1224,1196,1236,1239,43
65000070014,3730,3737,3723,3730,-7
65000070015,4108,4097,4030,3976,-121
65000070016,5345,5319,5191,5194,-125
65000070017,5510,5502,5537,5499,-3
65000070018,3437,3357,3319,3320,-37
65000070019,6380,6309,6251,6280,-29
65000070020,5157,5097,5243,5268,171
65000070021,1965,1998,2089,2131,133
65000070022,1875,1871,1804,1803,-68
65000070023,1928,1927,1913,1883,-44
65000070024,15453,15776,15995,16260,484
65000070025,2332,2310,2315,2303,-7
65000070026,9760,10012,10123,10256,244
65000070027,947,986,963,952,-34
65000070028,4648,4642,4668,4626,-16
65000070029,3978,3923,3863,3827,-96
65000070030,3790,3781,3775,3742,-39
65000070031,4192,4183,4206,4197,14
65000070032,4549,4573,4643,4701,128
65000070033,6297,6184,6143,6036,-148
65000070034,5519,5469,5419,5353,-116
65000070035,5990,6010,5994,6026,16
65000070036,5604,5580,5608,5551,-29
65000070037,3256,3227,3258,3265,38
65000070038,3568,3593,3625,3586,-7
65000070039,2900,2897,2891,2892,-5
65000070040,2921,2956,2971,2964,8
65000070041,1687,1649,1638,1621,-28
65000070042,2158,2220,2150,2196,-24
65000080001,1141,1163,1146,1110,-53
65000080002,2405,2340,2300,2310,-30
65000080003,6128,6063,6001,5990,-73
65000080004,4567,4562,4566,4541,-21
65000080005,1136,1135,1140,1131,-4
65000080006,615,624,636,618,-6
65000080007,1834,1803,1752,1720,-83
65000080008,9280,9079,9044,8922,-157
65000080009,3889,3795,3760,3710,-85
65000080010,7812,8214,8661,9087,873
65000080011,8495,8694,8694,8780,86
65000080012,1042,1026,1016,981,-45
65000080013,266,275,272,273,-2
65000080014,5389,5323,5273,5232,-91
65000080015,4845,4927,5296,5738,811
65000080016,4068,3914,3889,4151,237
65000080017,5291,5178,5208,5207,29
65000080018,6197,6053,5993,5980,-73
65000080019,4869,4779,4704,4622,-157
65000080020,7324,7414,7518,7571,157
65000090001,316,322,328,333,11
65000090002,694,704,687,694,-10
65000090003,4258,4255,4290,4267,12
65000090004,3258,3317,3396,3649,332
65000090005,1250,1227,1203,1206,-21
65000090006,7909,7995,7950,7831,-164
65000090007,6074,6047,6228,6298,251
65000090008,10677,10686,10678,10658,-28
65000090009,9936,10129,10312,10506,377
65000090010,4317,4285,4302,4325,40
65000090011,2567,2493,2426,2406,-87
65000090012,1222,1190,1174,1168,-22
65000090013,573,564,541,535,-29
65000090014,974,950,915,898,-52
65000090015,754,724,702,693,-31
65000090016,820,795,766,740,-55
65000090017,2511,2540,2494,2453,-87
65000090018,1652,1630,1590,1594,-36
65000090019,3246,3256,3233,3197,-59
65000090020,1017,1013,1006,988,-25
65000090021,1543,1532,1501,1460,-72
65000090022,2138,2123,2112,2084,-39
65000090023,7039,7091,7114,7078,-13
65000090024,8020,7901,7882,7827,-74
65000090025,5568,5518,5508,5500,-18
65000090026,3747,3749,3768,3749,0
65000090027,15941,16430,16729,16998,568
65000090028,6905,7354,7643,7782,428
65000100001,649,627,627,622,-5
65000100002,1191,1174,1153,1126,-48
65000100003,1673,1680,1678,1642,-38
65000100004,1706,1673,1657,1659,-14
65000100005,1126,1119,1103,1105,-14
65000100006,2852,2860,2791,2734,-126
65000100007,948,922,916,915,-7
65000100008,13282,15638,18030,20333,4695
65000100009,1723,1830,1836,1895,65
65000100010,7606,7691,7861,7826,135
65000100011,6184,6061,6093,6029,-32
65000100012,10769,10957,11115,11508,551
65000100013,2356,2311,2270,2252,-59
65000100014,1234,1220,1221,1217,-3
65000100015,1446,1473,1480,1489,16
65000100016,1457,1396,1384,1394,-2
65000100017,6915,6957,7097,7227,270
65000100018,6380,6318,6267,6401,83
65000100019,7287,7357,7397,7418,61
65000100020,5557,5850,6284,6585,735
65000100021,10590,10697,11216,11347,650
65000100022,6328,6375,6400,6452,77
65000100023,4193,4165,4229,4183,18
65000100024,1525,1504,1500,1468,-36
65000100025,1213,1224,1206,1215,-9
65000100026,814,797,786,770,-27
65000100027,1589,1584,1563,1516,-68
65000100028,976,962,935,921,-41
65000100029,772,770,750,738,-32
65000100030,465,462,463,443,-19
65000100031,1915,1909,1861,1869,-40
65000100032,5657,5626,5683,5681,55
65000100033,4248,4442,4576,4734,292
65000100034,4479,4447,4435,4378,-69
65000100035,8867,9080,9280,9628,548
65000100036,4910,4920,4958,4935,15
65000100037,4834,4869,4916,4977,108
65000100038,2896,2940,2926,2941,1
65000100039,4473,4477,4571,4689,212
65000100040,4293,4200,4113,4095,-105
65000100041,4839,4818,4793,4834,16
65000100042,7380,8120,9190,10087,1967
65000110001,1447,1414,1383,1375,-39
65000110002,1067,1071,1102,1126,55
65000110003,4753,4788,4851,4858,70
65000110004,351,346,348,354,8
65000110005,3140,3126,3253,3502,376
65000110006,5707,5745,5836,5808,63
65000110007,5827,5804,5742,5717,-87
65000110008,7287,7259,7300,7385,126
65000110009,4910,4878,4808,4846,-32
65000110010,1682,1670,1659,1672,2
65000110011,1705,1714,1694,1689,-25
65000110012,4640,4700,4887,4953,253
65000110013,2379,2403,2371,2355,-48
65000110014,6305,6285,6296,6298,13
65000110015,5219,5226,5314,5302,76
65000110016,1588,1581,1598,1610,29
65000110017,1051,1056,1024,1032,-24
65000110018,2198,2215,2173,2195,-20
65000110019,4539,4637,4778,4888,251
65000110020,5603,5587,5630,5761,174
65000110021,4528,4531,4554,4616,85
65000110022,4615,4650,4687,4718,68
65000110023,619,634,649,638,4
65000110024,3644,3692,3736,3766,74
65000110025,3007,3020,2988,3045,25
65000110026,7570,7736,7839,7943,207
65000110027,5837,5956,6073,6215,259
65000110028,1732,1773,1804,1834,61
65000110029,7630,7547,7646,7663,116
65000110030,8139,8234,8368,8424,190
65000110031,5255,5650,5999,6155,505
65000110032,4491,4514,4714,4830,316
65000110033,5170,5196,5311,5421,225
65000110034,3274,3300,3307,3308,8
65000110035,3065,3154,3173,3183,29
65000110036,5129,5159,5185,5256,97
65000110037,3469,3430,3431,3398,-32
65000110038,1238,1251,1250,1270,19
65000110039,4164,4181,4371,4633,452
65000110040,2766,2813,2871,2929,116
65000110041,2911,2917,2927,2931,14
65000110042,5331,5308,5339,5343,35
65000110043,6429,6413,6566,6644,231
65000110044,996,1008,979,950,-58
65000110045,6432,6454,6889,7174,720
65000110046,4674,4683,4751,4793,110
65000110047,5374,5471,5488,5470,-1
65000110048,4767,4706,4742,4753,47
65000110049,2730,2705,2780,2828,123
65000110050,2937,2944,2965,2990,46
65000120001,831,824,818,803,-21
65000120002,2284,2268,2227,2229,-39
65000120003,1410,1396,1344,1328,-68
65000120004,1908,1920,1904,1841,-79
65000120005,1512,1505,1507,1476,-29
65000120006,695,677,687,685,8
65000120007,4271,4211,4152,4103,-108
65000120008,1275,1247,1233,1215,-32
65000120009,1957,1904,1876,1874,-30
65000120010,1472,1458,1472,1458,0
65000120011,1886,1899,1884,1852,-47
65000120012,3473,3417,3367,3354,-63
65000120013,2272,2252,2208,2189,-63
65000120014,522,505,514,482,-23
65000120015,305,294,283,267,-27
65000120016,308,304,299,278,-26
65000120017,162,164,144,139,-25
65000120018,497,478,469,454,-24
65000120019,480,484,469,463,-21
65000120020,346,337,327,315,-22
65000120021,186,183,184,178,-5
65000120022,374,371,368,355,-16
65000120023,390,388,384,368,-20
65000120024,197,187,178,176,-11
65000120025,216,209,203,194,-15
65000120026,363,356,348,343,-13
65000120027,320,330,326,320,-10
65000120028,520,509,498,501,-8
65000120029,1361,1349,1350,1339,-10
65000120030,2235,2221,2206,2182,-39
65000120031,1418,1453,1455,1447,-6
65000120032,292,292,290,273,-19
65000120033,965,943,932,930,-13
65000120034,3650,3647,3630,3666,19
65000130001,5528,5510,5627,5668,158
65000130002,2154,2176,2186,2192,16
65000130003,6128,6236,6789,7243,1007
65000130004,5846,5845,5813,5773,-72
65000130005,2150,2114,2115,2156,42
65000130006,4898,4859,4834,4805,-54
65000130007,6091,6045,6154,6704,659
65000130008,4505,4580,4647,4655,75
65000130009,3602,3712,3729,4011,299
65000130010,8936,8932,8867,8781,-151
65000130011,3296,3229,3186,3134,-95
65000130012,8498,8475,8402,8346,-129
65000130013,6555,6496,6473,6355,-141
65000130014,4647,4638,4587,4551,-87
65000130015,1709,1687,1659,1648,-39
65000130016,7244,7172,7137,7133,-39
65000130017,7878,7667,7725,7628,-39
65000130018,7333,7226,7223,7256,30
65000130019,5096,5123,5118,5070,-53
65000130020,5051,5089,5128,5113,24
65000130021,8742,8663,8732,8756,93
65000130022,4757,4788,4811,4848,60
65000130023,5225,5233,5264,5215,-18
65000130024,5541,5547,5523,5516,-31
65000130025,3048,3097,3149,3175,78
65000130026,1757,1753,1735,1733,-20
65000130027,5395,5316,5245,5210,-106
65000130028,5990,5978,5920,5917,-61
65000130029,3783,3700,3713,3672,-28
65000130030,4747,4628,4615,4577,-51
65000130031,5227,5151,5132,5094,-57
65000130032,3175,3114,3119,3136,22
65000130033,5768,5704,5691,5636,-68
65000130034,4534,4512,4494,4499,-13
65000130035,4735,4750,4701,4644,-106
65000130036,5780,5798,5757,5688,-110
65000130037,4613,4626,4575,4508,-118
65000130038,5584,5534,5645,5774,240
65000130039,3449,3401,3378,3376,-25
65000130040,6811,6744,6875,7025,281
65000130041,3407,3389,3400,3398,9
65000130042,5078,5056,5087,5064,8
65000130043,6014,6059,6091,6092,33
65000130044,3664,3623,3640,3653,30
65000130045,3212,3169,3178,3168,-1
65000130046,6461,6375,6425,6340,-35
65000130047,4425,4382,4402,4341,-41
65000140001,14114,14532,15010,15338,806
65000140002,6047,6162,6326,6374,212
65000140003,4250,4329,4324,4297,-32
65000140004,5448,5525,5530,5533,8
65000140005,3981,4018,3941,3921,-97
65000140006,11060,10926,10913,10915,-11
65000140007,6625,6619,6650,6821,202
65000140008,5817,5727,5688,5736,9
65000140009,6450,6424,6492,6442,18
65000140010,3360,3319,3304,3292,-27
65000140011,3562,3493,3439,3355,-138
65000140012,2758,2714,2711,2688,-26
65000140013,2300,2278,2253,2183,-95
65000140014,3513,3461,3442,3429,-32
65000140015,6342,6281,6300,6353,72
65000140016,6720,6793,6693,6658,-135
65000140017,7377,7278,7193,7186,-92
65000140018,4252,4207,4222,4196,-11
65000140019,6079,6100,6102,6139,39
65000140020,3740,3704,3672,3646,-58
65000140021,9769,9880,9859,9920,40
65000140022,5519,5456,5485,5455,-1
65000140023,3433,3430,3421,3395,-35
65000140024,5695,5725,5703,5662,-63
65000140025,3502,3464,3407,3450,-14
65000140026,3234,3192,3148,3127,-65
65000140027,5760,5697,5715,5756,59
65000140028,5497,5555,5527,5567,12
65000140029,5191,5143,5179,5110,-33
65000140030,3036,3234,3576,3882,648
65000140031,5413,5350,5367,5419,69
65000140032,2857,2822,2797,2778,-44
65000140033,2602,2563,2560,2547,-16
65000140034,3439,3407,3383,3395,-12
65000140035,5410,5429,5468,5503,74
65000140036,4412,4343,4319,4294,-49
65000140037,7999,8023,8033,8033,10
65000140038,4746,4729,4731,4661,-68
65000150001,4969,4887,4826,4812,-75
65000150002,1261,1264,1244,1223,-41
65000150003,4011,4046,4053,4038,-8
65000150004,1506,1479,1451,1418,-61
65000150005,6372,6374,6448,6455,81
65000150006,6403,6633,6901,7288,655
65000150007,1514,1528,1468,1437,-91
65000150008,4623,4618,4606,4528,-90
65000150009,3735,3671,3642,3635,-36
65000150010,5523,5527,5537,5553,26
65000150011,2599,2611,2628,2611,0
65000150012,3203,3218,3190,3123,-95
65000150013,4651,4705,4674,4692,-13
65000150014,3230,3387,3472,3584,197
65000150015,3943,3961,3952,3997,36
65000150016,4096,4102,4145,4205,103
65000150017,3603,3634,3734,3832,198
65000150018,8063,9068,10326,11227,2159
65000150019,8174,8148,8172,8186,38
65000150020,3440,3468,3531,3626,158
65000160001,1028,984,972,954,-30
65000160002,3783,3753,3766,3674,-79
65000160003,7146,7141,7179,7142,1
65000160004,3004,2998,2972,2944,-54
65000160005,4728,4710,4736,4670,-40
65000160006,4347,4315,4352,4329,14
65000160007,5023,4986,5073,5100,114
65000160008,3865,3853,3813,3948,95
65000160009,4127,4095,4132,4172,77
65000160010,5188,5192,5192,5198,6
65000160011,4231,4195,4145,4091,-104
65000160012,8953,9040,9105,9055,15
65000160013,2299,2300,2248,2220,-80
65000160014,3499,3494,3455,3369,-125
65000160015,3884,3872,3888,3827,-45
65000160016,3938,3875,3841,3772,-103
65000160017,9868,9905,9882,9947,42
65000170001,4479,4395,4293,4208,-187
65000170002,5862,5857,5809,5777,-80
65000170003,10125,10604,11317,11572,968
65000170004,4656,4561,4562,4496,-65
65000170005,4448,4567,4795,4988,421
65000170006,1647,1608,1629,1622,14
65000170007,21675,23277,24901,26848,3571
65000170008,18627,20688,23111,25892,5204
65000170009,6516,6451,7116,7682,1231
65000170010,1211,1189,1165,1172,-17
65000170011,1459,1446,1436,1438,-8
65000170012,1099,1082,1067,1066,-16
65000170013,1006,994,952,919,-75
65000170014,1697,1723,1744,1783,60
65000170015,7450,7482,7496,7551,69
65000170016,9810,9843,9824,9824,-19
65000170017,4334,4314,4365,4354,40
65000180001,3480,3461,3510,3517,56
65000180002,2595,2553,2563,2585,32
65000180003,3152,3144,3169,3168,24
65000180004,2197,2187,2161,2182,-5
65000180005,643,631,626,628,-3
65000180006,6469,6530,6529,6478,-52
65000180007,2774,2759,2786,2768,9
65000180008,2350,2369,2381,2397,28
65000190001,443,438,438,421,-17
65000190002,875,879,864,869,-10
65000190003,782,770,741,740,-30
65000190004,717,706,695,659,-47
65000190005,340,348,335,322,-26
65000190006,433,428,429,429,1
65000190007,687,676,673,674,-2
65000190008,833,835,808,805,-30
65000190009,276,304,294,283,-21
65000190010,322,344,335,339,-5
65000190011,908,916,929,935,19
65000190012,1067,1087,1088,1089,2
65000200001,928,922,939,936,14
65000200002,1423,1470,1503,1528,58
65000200003,1273,1287,1291,1302,15
65000200004,455,454,449,451,-3
65000200005,900,915,910,906,-9
65000200006,697,691,695,690,-1
65000200007,852,873,902,890,17
65000210001,351,345,347,337,-8
65000210002,5626,5604,5615,5581,-23
65000210003,1152,1185,1202,1206,21
65000210004,966,910,871,853,-57
65000210005,7304,7201,7144,7089,-112
65000210006,713,709,683,668,-41
65000210007,546,544,537,527,-17
65000210008,773,770,738,721,-49
65000210009,2249,2258,2235,2202,-56
65000210010,902,890,866,860,-30
65000210011,616,598,590,591,-7
65000210012,676,656,640,629,-27
65000210013,1326,1308,1300,1276,-32
65000220001,1345,1300,1284,1254,-46
65000220002,1629,1594,1538,1507,-87
65000220003,2539,2497,2424,2331,-166
65000220004,991,989,973,948,-41
65000220005,1840,1834,1810,1749,-85
65000220006,1770,1759,1705,1677,-82
65000220007,360,351,337,326,-25
65000220008,726,700,687,645,-55
65000220009,1086,1091,1076,1043,-48
65000230001,7400,7394,7468,7454,60
65000230002,3653,3703,3750,3744,41
65000230003,3206,3349,3600,3664,315
65000230004,4103,4162,4242,4315,153
65000230005,2164,2192,2456,2472,280
65000230006,7573,7608,7598,7623,15
65000230007,4893,4961,4840,4902,-59
65000230008,1981,1959,1954,1954,-5
65000230009,1765,1786,1812,1816,30
65000230010,1755,1792,1811,1797,5
65000240001,427,416,408,395,-21
65000240002,272,256,247,242,-14
65000240003,267,273,266,254,-19
65000240004,488,497,485,460,-37
65000240005,267,265,263,281,16
65000240006,696,688,659,639,-49
65000240007,449,446,440,436,-10
65000240008,158,154,156,154,0
65000240009,381,378,368,356,-22
65000240010,183,186,186,171,-15
65000240011,959,943,904,876,-67
65000240012,172,164,164,160,-4
65000250001,510,512,507,490,-22
65000250002,437,424,404,393,-31
65000250003,869,870,837,817,-53
65000250004,785,794,773,750,-44
65000250005,432,417,395,377,-40
65000250006,1776,1715,1661,1610,-105
65000250007,347,352,342,341,-11
65000250008,1074,1042,1003,983,-59
65000250009,693,686,680,661,-25
65000250010,455,448,428,408,-40
65000250011,393,392,386,378,-14
65000250012,1168,1208,1249,1260,52
65000260001,982,947,938,903,-44
65000260002,540,541,509,490,-51
65000260003,762,737,715,691,-46
65000260004,457,464,439,433,-31
65000260005,754,733,711,700,-33
65000260006,1894,1852,1791,1764,-88
65000260007,1968,1939,1894,1877,-62
65000260008,2308,2249,2230,2189,-60
65000260009,967,946,929,920,-26
65000260010,820,808,800,768,-40
65000260011,1100,1085,1077,1047,-38
65000270001,555,540,518,505,-35
65000270002,803,803,786,797,-6
65000270003,580,568,580,566,-2
65000270004,2064,2033,1973,1935,-98
65000270005,4588,4569,4505,4443,-126
65000270006,1987,1955,1913,1896,-59
65000270007,1378,1327,1288,1281,-46
65000270008,463,456,429,418,-38
65000270009,735,763,732,715,-48
65000270010,735,721,712,684,-37
65000270011,962,940,924,902,-38
65000270012,539,530,510,510,-20
65000270013,204,210,193,183,-27
65000270014,646,643,635,626,-17
65000270015,5776,5716,5698,5666,-50
65000280001,5082,5015,5014,4966,-49
65000280002,2882,2884,2877,2851,-33
65000280003,3737,3697,3632,3603,-94
65000280004,3151,3120,3077,3052,-68
65000280005,657,651,663,659,8
65000280006,1072,1066,1059,1077,11
65000280007,739,726,709,706,-20
65000280008,466,462,457,452,-10
65000280009,1300,1287,1278,1276,-11
65000280010,3210,3160,3106,3068,-92
65000290001,2808,2886,2893,2865,-21
65000290002,1866,1877,1865,1886,9
65000290003,804,829,830,820,-9
65000290004,587,589,596,602,13
65000290005,255,257,249,243,-14
63000010002,5530,5489,5446,5284,-205
63000010003,8291,8338,8218,8096,-242
63000010004,7100,7041,6962,6881,-160
63000010005,4807,4689,4679,4602,-87
63000010006,5422,5328,5318,5228,-100
63000010007,5154,5100,5110,5012,-88
63000010008,4801,4793,4720,4652,-141
63000010009,4779,4745,4733,4656,-89
63000010010,4628,4601,4658,4606,5
63000010011,7349,7244,7115,6940,-304
63000010012,11107,11206,11249,11114,-92
63000010013,2946,2942,2864,2826,-116
63000010014,4586,4545,4491,4400,-145
63000010015,6759,6716,6817,6731,15
63000010016,9063,8981,8911,8702,-279
63000010017,6537,6461,6380,6141,-320
63000010018,8180,8078,8134,8075,-3
63000010019,8564,8659,8528,8353,-306
63000010020,5473,5576,5477,5438,-138
63000010021,10068,10211,10100,9385,-826
63000010022,8743,8614,8396,8186,-428
63000010024,8322,8251,8073,7923,-328
63000010025,6650,6528,6409,6219,-309
63000010026,10711,10543,10486,10398,-145
63000010027,4513,4430,4448,4430,0
63000010028,3752,3764,3774,3737,-27
63000010029,4224,4214,4230,4155,-59
63000010030,7480,7331,7296,7200,-131
63000010031,3392,3405,3455,3411,6
63000010032,4862,4772,4768,4769,-3
63000010033,6648,6624,6553,6437,-187
63000010034,2818,2758,2713,2675,-83
63000010035,3729,3725,3682,3654,-71
63000020001,6024,5912,5804,5789,-123
63000020002,4793,4775,4763,4636,-139
63000020003,3000,2900,2755,2646,-254
63000020004,3689,3573,3548,3420,-153
63000020005,3492,3484,3407,3323,-161
63000020006,5968,5893,5779,5606,-287
63000020007,5436,5367,5258,5193,-174
63000020008,8367,8287,8140,7920,-367
63000020009,11215,11118,11021,10895,-223
63000020010,3930,3885,3843,3789,-96
63000020011,5229,5108,5147,5026,-82
63000020012,3872,3764,3688,3600,-164
63000020013,5135,5047,4892,4734,-313
63000020014,4166,4129,4065,3948,-181
63000020015,4351,4382,4328,4205,-177
63000020016,5749,5737,5568,5499,-238
63000020017,5531,5441,5311,5192,-249
63000020018,5088,5067,5016,4932,-135
63000020019,4548,4551,4525,4449,-102
63000020020,8169,8151,7972,7829,-322
63000020021,2346,2293,2227,2213,-80
63000020022,7184,7148,7097,6921,-227
63000020023,5039,5009,4929,4825,-184
63000020024,4650,4536,4479,4359,-177
63000020025,8337,8207,8025,7806,-401
63000020026,6216,6220,6161,6002,-218
63000020027,4150,4110,4081,3971,-139
63000020028,5312,5296,5295,5200,-96
63000020029,6786,6734,6637,6516,-218
63000020030,9204,9143,8989,8867,-276
63000020031,5406,5351,5355,5241,-110
63000020032,6901,6910,6820,6681,-229
63000020033,8195,8065,7983,7663,-402
63000020034,4725,4663,4652,4582,-81
63000020035,4182,4149,4017,3890,-259
63000020036,7413,7361,7209,7086,-275
63000020037,3247,3230,3160,3083,-147
63000020038,4254,4151,4115,3994,-157
63000020039,7296,7212,7069,6945,-267
63000020040,5025,4954,4828,4783,-171
63000020041,2133,2093,2063,1981,-112
63000030001,5939,5928,5917,5736,-192
63000030002,5832,5825,5851,5834,9
63000030003,7478,7443,7296,7125,-318
63000030004,8430,8428,8434,8374,-54
63000030005,5454,5437,5388,5178,-259
63000030006,5726,5696,5574,5431,-265
63000030007,7044,6947,6835,6706,-241
63000030008,3188,3145,3136,3093,-52
63000030009,4171,4159,4098,3996,-163
63000030010,7781,7737,7598,7424,-313
63000030011,6146,6142,6122,6023,-119
63000030012,5098,5209,5345,5356,147
63000030013,4334,4310,4335,4315,5
63000030014,7406,7495,7632,7629,134
63000030015,8466,8434,8442,8470,36
63000030016,6485,6440,6515,6490,50
63000030017,6894,6910,6931,6833,-77
63000030018,4055,4065,4017,4005,-60
63000030019,3889,3988,4049,4134,146
63000030020,3897,3961,4029,4086,125
63000030021,6228,6229,6304,6263,34
63000030022,7064,7021,6957,6824,-197
63000030023,7184,7177,7214,7133,-44
63000030026,3584,3554,3498,3511,-43
63000030027,4996,4950,4879,4736,-214
63000030028,7183,7137,7150,7055,-82
63000030029,5387,5325,5239,5014,-311
63000030030,5479,5453,5423,5303,-150
63000030031,6358,6330,6327,6219,-111
63000030032,5772,5625,5517,5415,-210
63000030033,4294,4235,4210,4122,-113
63000030034,4604,4592,4534,4441,-151
63000030035,4549,4483,4439,4411,-72
63000030036,6027,5982,5943,5779,-203
63000030037,7154,7056,6975,6842,-214
63000030038,3993,3925,3912,3808,-117
63000030039,2280,2340,2390,2374,34
63000030040,10323,10361,10374,10194,-167
63000030041,4626,4644,4722,4640,-4
63000030043,8785,8840,8902,8723,-117
63000030044,5897,5876,5820,5787,-89
63000030046,5716,5714,5630,5562,-152
63000030047,7832,7813,7798,7678,-135
63000030048,4933,4928,4814,4521,-407
63000030049,5193,5164,5059,4912,-252
63000030050,6486,6448,6442,6307,-141
63000030051,6697,6668,6643,6513,-155
63000030052,5045,4953,4913,4750,-203
63000030053,6629,6586,6518,6433,-153
63000030054,4418,4383,4362,4287,-96
63000030055,6598,6521,6506,6358,-163
63000030056,8139,8050,7944,7815,-235
63000030057,2803,2781,2729,2676,-105
63000040001,3263,3320,3322,3271,-49
63000040002,5389,5363,5297,5251,-112
63000040003,3754,3721,3711,3640,-81
63000040004,4692,4647,4553,4504,-143
63000040005,2622,2629,2613,2610,-19
63000040006,6773,6858,6851,6752,-106
63000040007,4244,4300,4209,4156,-144
63000040008,7390,7484,7443,7243,-241
63000040009,4076,4068,4052,3987,-81
63000040010,5045,4994,5029,5067,73
63000040011,5572,5597,5574,5506,-91
63000040012,4387,4399,4338,4253,-146
63000040013,3917,3859,3822,3730,-129
63000040014,9878,9735,9603,9309,-426
63000040015,7193,7235,7093,6962,-273
63000040016,9999,9929,9867,9657,-272
63000040017,1147,1114,1107,1087,-27
63000040018,5580,5503,5381,5201,-302
63000040019,5204,5178,5073,4916,-262
63000040020,5334,5326,5247,5212,-114
63000040021,6777,6709,6586,6498,-211
63000040022,5059,5028,4934,4772,-256
63000040023,5286,5235,5161,4998,-237
63000040024,7697,7596,7524,7366,-230
63000040025,8524,8447,8304,8046,-401
63000040026,4258,4235,4216,4228,-7
63000040027,7777,7680,7649,7489,-191
63000040028,7233,7176,7117,6953,-223
63000040029,7807,7751,7643,7540,-211
63000040030,5879,5883,5891,5806,-77
63000040031,5208,5235,5192,5177,-58
63000040032,5427,5453,5389,5455,2
63000040033,3884,3907,3787,3723,-184
63000040034,6241,6101,6061,5959,-142
63000040035,5124,5077,5084,4959,-118
63000040036,4721,4665,4644,4627,-38
63000040037,3529,3393,3313,3272,-121
63000040038,2908,2874,2952,2944,70
63000040039,6175,6179,6180,6181,2
63000040040,4831,4837,4813,4766,-71
63000040041,8081,8024,8034,8133,109
63000040042,2825,2712,2728,2670,-42
63000050001,3081,3060,3099,3039,-21
63000050002,2687,2705,2693,2614,-91
63000050003,2363,2480,2583,2609,129
63000050004,4781,4748,4844,4779,31
63000050005,4710,4643,4586,4487,-156
63000050006,6206,6123,6012,5957,-166
63000050007,5984,5945,5866,5695,-250
63000050008,3380,3332,3250,3189,-143
63000050009,5567,5658,5643,5528,-130
63000050010,4531,4453,4424,4261,-192
63000050011,6505,6495,6251,6289,-206
63000050012,5185,5052,4982,4857,-195
63000050013,4456,4334,4193,4034,-300
63000050014,6668,6577,6410,6232,-345
63000050015,4881,4991,4996,4882,-109
63000050016,3507,3493,3485,3431,-62
63000050017,2894,2880,2916,2843,-37
63000050018,3785,3687,3645,3539,-148
63000050019,11346,11511,11796,12111,600
63000050020,6417,6209,6014,5684,-525
63000050021,10148,10164,10010,9786,-378
63000050022,1740,1811,1796,1776,-35
63000050023,4000,3981,3934,3928,-53
63000050024,3503,3469,3475,3528,59
63000050025,3227,3228,3181,3108,-120
63000050026,6018,5864,5786,5749,-115
63000050027,4651,4541,4517,4357,-184
63000050028,4184,4124,4089,3980,-144
63000050029,5827,5836,5855,5727,-109
63000050030,8432,8571,8596,8445,-126
63000050031,8944,9035,9087,8953,-82
63000060001,3101,3054,3008,2944,-110
63000060002,3517,3447,3387,3271,-176
63000060003,4895,4876,4895,4767,-109
63000060004,4032,3941,3870,3799,-142
63000060005,5589,5533,5383,5165,-368
63000060006,4554,4518,4521,4419,-99
63000060007,6432,6413,6343,6246,-167
63000060008,5399,5351,5337,5258,-93
63000060009,5114,5035,4905,4751,-284
63000060010,4350,4286,4278,4200,-86
63000060011,10102,9919,9791,9638,-281
63000060012,4255,4278,4222,4137,-141
63000060013,6902,6808,6729,6632,-176
63000060014,2868,2781,2747,2673,-108
63000060015,3252,3268,3204,3417,149
63000060016,5101,5119,5041,4978,-141
63000060017,2929,2809,2705,2664,-145
63000060018,4582,4592,4660,4673,81
63000060019,4460,4494,4556,4483,-11
63000060020,5569,5077,4875,4723,-354
63000060021,6668,6661,6581,6523,-138
63000060022,8348,8274,8158,7903,-371
63000060024,6177,6094,6022,5844,-250
63000060025,6840,6780,6674,6756,-24
63000060026,4242,4217,4151,3985,-232
63000070001,5709,5641,5585,5453,-188
63000070002,3507,3405,3337,3263,-142
63000070003,3918,3849,3822,3729,-120
63000070004,6685,6677,6884,6800,123
63000070005,6271,6342,6318,6224,-118
63000070006,5889,5858,5845,5827,-31
63000070007,5057,5006,4979,4860,-146
63000070008,4101,4093,3996,3938,-155
63000070009,4939,4851,4798,4704,-147
63000070010,6332,6156,6065,6038,-118
63000070011,7561,7402,7205,7033,-369
63000070012,4884,4805,4733,4641,-164
63000070013,3511,3509,3464,3430,-79
63000070014,8626,8625,8534,8278,-347
63000070015,5719,5628,5564,5451,-177
63000070016,7177,7120,6942,6665,-455
63000070017,4500,4449,4411,4313,-136
63000070018,8890,8885,8654,8416,-469
63000070019,5462,5404,5287,5132,-272
63000070020,3898,3844,3831,3776,-68
63000070021,6392,6307,6189,6048,-259
63000070022,4636,4631,4586,4553,-78
63000070023,3469,3352,3245,3215,-137
63000070024,7354,7165,6815,6549,-616
63000070025,5795,5703,5647,5551,-152
63000070026,4644,4567,4480,4407,-160
63000070027,3548,3421,3340,3236,-185
63000070028,4866,4867,4780,4625,-242
63000070029,3780,3758,3690,3595,-163
63000070030,5453,5402,5262,5083,-319
63000070031,5020,4929,4768,4663,-266
63000070032,6521,6421,6295,6129,-292
63000070033,5748,5696,6098,6047,351
63000070034,4960,4933,4848,4787,-146
63000070035,3848,3769,3716,3607,-162
63000070036,3180,3133,3063,3022,-111
63000080001,7953,8091,8089,8283,192
63000080002,7735,7713,7609,7528,-185
63000080003,5504,5452,5478,5333,-119
63000080004,6994,6931,6827,6703,-228
63000080005,5195,5491,5743,5833,342
63000080006,6072,6153,6103,5959,-194
63000080007,5889,5906,5866,5704,-202
63000080008,4686,4706,4745,4653,-53
63000080009,7647,7586,7560,7417,-169
63000080010,5556,5523,5390,5344,-179
63000080011,3393,3395,3389,3355,-40
63000080012,4888,4822,4774,4696,-126
63000080013,5124,5073,5047,5045,-28
63000080014,3510,3468,3440,3508,40
63000080015,7856,7828,7670,7562,-266
63000080016,6172,6075,5972,5978,-97
63000080017,5542,5627,5545,5406,-221
63000080018,6937,6988,7003,6928,-60
63000080019,6161,6074,5976,5862,-212
63000080020,8700,8705,8584,8378,-327
63000080021,4079,4059,4042,4045,-14
63000080022,7003,6957,6851,6687,-270
63000080023,7167,7177,7111,6901,-276
63000080024,9328,9415,9351,9194,-221
63000080025,4551,4405,4736,4643,238
63000080026,7111,7034,7026,6847,-187
63000080027,9190,9193,9103,9042,-151
63000080028,10562,10499,10298,10144,-355
63000080029,8062,7919,7776,7642,-277
63000080030,8888,8791,8584,8424,-367
63000080031,5915,5873,5807,5697,-176
63000080032,6021,5967,5902,5674,-293
63000080033,8313,8211,8105,7960,-251
63000080034,6113,6130,6121,6069,-61
63000080035,8846,8855,8829,8704,-151
63000080036,4098,4124,4141,4108,-16
63000080037,981,969,939,923,-46
63000080038,4141,4148,4126,4213,65
63000080039,7652,7646,7512,7384,-262
63000080040,8085,8089,8144,8115,26
63000080041,6513,6403,6408,6311,-92
63000080042,5079,5132,5070,5030,-102
63000080043,5212,5159,5014,4898,-261
63000090001,6653,6798,6798,6774,-24
63000090002,3983,3961,3866,3727,-234
63000090003,4244,4185,4130,3965,-220
63000090004,7664,7832,7941,8051,219
63000090005,7625,7652,7596,7387,-265
63000090006,3965,3892,3765,3705,-187
63000090007,4931,4917,4869,5712,795
63000090008,5049,5018,4931,4798,-220
63000090009,5075,5025,4965,4869,-156
63000090010,7062,6944,6833,6687,-257
63000090011,7997,7922,7879,7634,-288
63000090012,4412,4423,4369,4230,-193
63000090013,4729,4660,4583,4481,-179
63000090014,5655,5605,5526,5416,-189
63000090015,5324,5294,5189,5027,-267
63000090016,9609,9430,9235,8920,-510
63000090017,9840,9871,9750,9634,-237
63000090018,6742,6692,6721,6600,-92
63000090019,5836,5807,5682,5591,-216
63000090020,5760,5742,5669,5550,-192
63000100001,7464,7453,7284,7073,-380
63000100002,9726,9784,9676,9570,-214
63000100003,6848,6801,6701,6612,-189
63000100005,6417,6384,6385,6290,-94
63000100006,6039,5963,5971,5907,-56
63000100007,10076,10041,9891,9774,-267
63000100008,9772,9796,9891,9849,53
63000100009,6159,6261,6278,6295,34
63000100010,8680,8715,8643,8572,-143
63000100011,8314,8301,8182,8053,-248
63000100012,5725,5736,5666,5555,-181
63000100013,5595,5550,5478,5384,-166
63000100014,7030,7035,6998,7003,-32
63000100015,7343,7371,7348,7186,-185
63000100016,6178,6104,5997,5814,-290
63000100017,8888,8861,8854,8679,-182
63000100018,7922,7924,7890,7792,-132
63000100019,8462,8345,8226,8148,-197
63000100020,8072,7996,7841,7634,-362
63000100021,4796,4779,4690,4574,-205
63000100022,11901,11830,11832,11655,-175
63000100023,8106,8029,7829,7935,-94
63000100024,9203,9053,8866,8666,-387
63000100025,5022,4915,4875,4803,-112
63000100026,8315,8627,8921,9059,432
63000100027,7063,7097,7222,7217,120
63000100028,4117,4205,4119,4035,-170
63000100029,8935,8801,8733,8608,-193
63000100030,5699,5701,5619,5458,-243
63000100031,8331,8365,8316,8153,-212
63000100032,6489,6436,6342,6196,-240
63000100033,5844,5798,5707,5614,-184
63000100034,10601,10586,10508,10405,-181
63000100035,9571,9632,9627,9457,-175
63000100036,6026,6013,5975,5961,-52
63000100037,1420,1419,1422,1378,-41
63000100038,6385,6370,6300,6301,-69
63000100039,9078,9240,9535,9742,502
63000100040,6159,6112,6157,6118,6
63000110001,4166,4078,4002,3920,-158
63000110002,3421,3416,3415,3239,-177
63000110003,3163,3111,3040,2958,-153
63000110004,6120,6039,5974,5811,-228
63000110005,7894,7843,7780,7652,-191
63000110006,6466,6467,6372,6201,-266
63000110007,8194,8147,8037,7897,-250
63000110008,8611,8536,8465,8284,-252
63000110009,7355,7308,7143,7008,-300
63000110010,4904,4790,4673,4617,-173
63000110011,7577,7494,7369,7106,-388
63000110012,5823,5770,5709,5612,-158
63000110013,6642,6620,6418,6281,-339
63000110014,5204,5119,5023,4926,-193
63000110015,5543,5620,5604,5530,-90
63000110016,6211,6178,6137,6039,-139
63000110017,8109,8027,7908,7731,-296
63000110018,4320,4302,4269,4237,-65
63000110019,6860,6810,6725,6614,-196
63000110020,9671,9606,9454,9267,-339
63000110021,7733,7704,7616,7453,-251
63000110022,7587,7411,7261,7153,-258
63000110023,5009,4980,4985,5076,96
63000110024,6111,6046,6238,6308,262
63000110025,3534,3507,3495,3400,-107
63000110026,7441,7414,7360,7213,-201
63000110027,4583,4585,4546,4523,-62
63000110028,5837,5864,5823,5773,-91
63000110029,5352,5280,5195,5131,-149
63000110030,5820,5786,5722,5600,-186
63000110031,7943,7884,7865,7742,-142
63000110032,5372,5357,5310,5207,-150
63000110033,6089,6068,6003,5823,-245
63000110034,9113,9074,9092,8894,-180
63000110035,6767,6713,6544,6505,-208
63000110036,6664,6668,6667,6568,-100
63000110037,5494,5506,5454,5349,-157
63000110038,5355,5360,5308,5269,-91
63000110039,8038,8013,7851,7698,-315
63000110040,7270,7269,7237,7113,-156
63000110041,9416,9351,9240,9069,-282
63000110042,7090,7036,6943,6824,-212
63000110043,1296,1301,1281,1262,-39
63000110044,1432,1430,1411,1415,-15
63000110045,1993,1971,1939,1890,-81
63000110046,3111,3124,3100,3061,-63
63000110047,1671,1658,1625,1588,-70
63000110048,1549,1542,1547,1502,-40
63000110049,1540,1568,1547,1545,-23
63000110050,2764,2740,2736,2657,-83
63000110051,3067,3053,3001,2910,-143
63000120001,4397,4424,4398,4390,-34
63000120002,4392,4401,4431,4358,-43
63000120003,5525,5445,5340,5279,-166
63000120004,7610,7601,7497,7463,-138
63000120005,8067,8104,8032,8005,-99
63000120006,7764,7736,7620,7491,-245
63000120007,8084,8056,7937,7884,-172
63000120008,8098,7990,7852,7767,-223
63000120009,9610,9562,9494,9469,-93
63000120010,8311,8453,8460,8478,25
63000120011,5308,5343,5316,5260,-83
63000120012,4748,4721,4687,4718,-3
63000120013,7628,7612,7574,7434,-178
63000120014,5764,5617,5516,5463,-154
63000120015,5119,5107,5085,5033,-74
63000120016,5913,5909,5922,5848,-61
63000120017,9647,9714,9684,9613,-101
63000120018,5839,5770,5707,5538,-232
63000120019,2186,2052,2314,2450,398
63000120020,10321,10525,10759,10970,445
63000120021,9751,9654,9557,9577,-77
63000120022,8975,8893,8675,8467,-426
63000120023,6468,6548,6445,6294,-254
63000120024,6186,6068,6008,5672,-396
63000120025,6943,6879,6763,6624,-255
63000120026,3185,3174,3116,3049,-125
63000120027,6680,6678,6573,6478,-200
63000120028,4448,4438,4350,4179,-259
63000120029,6872,6810,6783,6712,-98
63000120030,5150,5094,5070,4971,-123
63000120031,6531,6410,6311,6210,-200
63000120032,3423,3381,3320,3273,-108
63000120033,4524,4486,4373,4249,-237
63000120034,4833,4798,4709,4635,-163
63000120035,5666,5690,5540,5434,-256
63000120036,6318,6290,6145,6027,-263
63000120037,7838,7830,7809,7571,-259
63000120038,11901,11859,11836,11577,-282
63000120039,2446,2475,2425,2381,-94
63000120040,1741,1685,1660,1626,-59
63000120041,1249,1265,1277,1294,29
63000120042,997,985,949,933,-52
68000010001,816,802,967,1142,340
68000010002,1585,1601,1605,1581,-20
68000010003,1795,1812,1837,1893,81
68000010004,13298,8803,9007,9078,275
68000010005,10055,4341,4364,4306,-35
68000010006,10957,11171,11422,11784,613
68000010007,1192,1189,1170,1163,-26
68000010008,1708,1688,1679,1822,134
68000010009,1979,1957,2109,2097,140
68000010010,5895,6300,6731,7266,966
68000010011,5572,5553,5544,5499,-54
68000010012,5587,5601,5530,5431,-170
68000010013,3382,3449,3435,3471,22
68000010014,2166,2249,2240,2236,-13
68000010015,1141,1157,1122,1073,-84
68000010016,4441,4406,4405,4332,-74
68000010017,2586,2663,2737,2789,126
68000010018,3698,3691,3716,3653,-38
68000010019,1905,1898,1853,1888,-10
68000010020,1565,1588,1564,1526,-62
68000010021,1033,991,936,958,-33
68000010022,11151,11435,11534,11883,448
68000010023,8073,8259,8346,8419,160
68000010024,7610,7774,7819,7936,162
68000010025,1767,1738,1754,1728,-10
68000010026,7151,7038,6995,7040,2
68000010027,1659,1646,1660,1649,3
68000010028,5891,5927,5889,5842,-85
68000010029,5233,5248,5634,6323,1075
68000010030,5951,6314,6976,7527,1213
68000010031,1959,1938,1968,1983,45
68000010032,7456,7549,7537,7520,-29
68000010033,7444,7447,7517,7615,168
68000010034,6148,6078,5955,5778,-300
68000010035,4214,4161,4139,4061,-100
68000010036,7022,7032,7021,7013,-19
68000010037,4670,4688,4690,4708,20
68000010038,5282,5336,5344,5272,-64
68000010039,2378,2343,2362,2325,-18
68000010040,6601,6620,6724,6998,378
68000010041,7549,7550,7526,7504,-46
68000010042,5977,6100,6064,6026,-74
68000010043,6131,6118,6063,5939,-179
68000010044,5195,5225,5184,5142,-83
68000010045,5153,5289,5243,5193,-96
68000010046,12554,6450,6501,6339,-111
68000010047,7400,7469,7477,7371,-98
68000010048,8635,8718,8692,8703,-15
68000010049,7567,7750,7830,7895,145
68000010050,9941,10546,11025,11649,1103
68000010051,10218,10412,10509,10538,126
68000010052,3019,3111,3491,4366,1255
68000010053,4502,4443,4438,4353,-90
68000010054,4629,4686,4722,4651,-35
68000010055,8061,8202,8126,8047,-155
68000010056,5921,6103,6152,6115,12
68000010057,7276,7500,7841,8068,568
68000010058,9985,10118,10174,10239,121
68000010059,10869,11011,11283,11408,397
68000010060,6120,6481,6658,6714,233
68000010061,8792,8856,8958,8881,25
68000010062,6964,6987,6943,6881,-106
68000010063,5815,5918,6013,6073,155
68000010064,5488,5539,5534,5510,-29
68000010065,5650,5678,5701,5643,-35
68000010066,5071,5127,5056,5068,-59
68000010067,5940,6049,6144,6204,155
68000010068,7738,7851,7893,7948,97
68000010069,5603,5761,5784,5893,132
68000010070,6658,6734,6783,6776,42
68000010071,6980,7329,7772,8073,744
68000010072,7865,7912,8025,7963,51
68000010073,3925,3951,3961,3984,33
68000010074,10200,10270,10354,10216,-54
68000010075,7232,7443,7576,7513,70
68000010076,4201,4268,4557,4605,337
68000020001,3587,3575,3545,3512,-63
68000020002,6381,6401,6404,6298,-103
68000020003,3721,3707,3705,3696,-11
68000020004,1088,1079,1072,1041,-38
68000020005,2558,2535,2556,2558,23
68000020006,5269,5270,5258,5299,29
68000020007,6519,6543,6552,6497,-46
68000020008,5998,6050,6058,5992,-58
68000020009,4187,4193,4195,4160,-33
68000020010,4758,4773,4743,4686,-87
68000020011,5108,5126,5066,5034,-92
68000020012,6719,6756,6910,6985,229
68000020013,3425,3529,3508,3481,-48
68000020014,2260,2375,2507,2606,231
68000020015,4137,4127,4127,4061,-66
68000020016,5490,5538,5631,5534,-4
68000020017,6463,6577,6590,6664,87
68000020018,4266,4503,4699,4832,329
68000020019,5928,6010,6327,6360,350
68000020020,4033,4113,4170,4173,60
68000020021,3974,4093,4135,4071,-22
68000020022,5190,6321,7220,8569,2248
68000020023,3054,3144,3143,3204,60
68000020024,4485,4474,4474,4481,7
68000020025,4616,4598,4585,4631,33
68000020026,4452,4440,4440,4416,-24
68000020027,8213,8402,8509,8565,163
68000020028,877,864,873,865,1
68000020029,5644,5681,5726,5600,-81
68000020030,3418,3379,3359,3312,-67
68000020031,4107,4112,4081,4081,-31
68000020032,3880,4545,5505,7677,3132
68000020033,11944,12282,12638,12960,678
68000020034,10925,10984,11088,11147,163
68000020035,2338,2329,2294,2225,-104
68000020036,8818,8921,9192,9217,296
68000020037,5607,5637,5669,5643,6
68000020038,2036,2051,2029,1979,-72
68000020039,5950,5981,5972,5946,-35
68000020040,1237,1254,1236,1229,-25
68000020041,3552,3567,3604,3551,-16
68000020042,5735,5869,5784,5746,-123
68000020043,7581,8346,8939,9690,1344
68000020044,7433,7525,7475,7576,51
68000020045,1815,1809,1764,1767,-42
68000020046,3762,4018,4237,4706,688
68000020047,6148,6374,6597,6723,349
68000020048,3809,3783,3795,3842,59
68000020049,4410,4408,4410,4373,-35
68000020050,1146,1127,1080,1076,-51
68000020051,5421,5568,5647,5684,116
68000020052,5389,5641,5645,5588,-53
68000020053,3239,3269,3271,3275,6
68000020054,3471,3304,3295,3315,11
68000020055,6590,6733,6741,6721,-12
68000020056,6673,6849,7130,7195,346
68000020057,5797,5877,5862,5906,29
68000020058,3333,3415,3438,3392,-23
68000020059,3252,3255,3234,3187,-68
68000020060,4412,4492,4537,4457,-35
68000020061,4543,4525,4510,4485,-40
68000020062,5896,5971,6039,6095,124
68000020063,4332,4362,4420,4489,127
68000020064,4259,4296,4231,4263,-33
68000020065,4853,4880,4859,4830,-50
68000020066,5327,5311,5361,5359,48
68000020067,2602,2559,2527,2468,-91
68000020068,5669,5679,5709,5773,94
68000020069,3105,3063,3022,2995,-68
68000020070,4549,4632,4712,4601,-31
68000020071,4095,4303,4372,4605,302
68000020072,5525,5595,5644,5660,65
68000020073,7084,7107,7120,7179,72
68000020074,6487,6501,6476,6419,-82
68000020075,4503,4469,4466,4444,-25
68000020076,4238,4295,4346,4356,61
68000020077,4038,4079,4122,4030,-49
68000020078,4025,4028,4156,4340,312
68000020079,5821,5870,5922,5912,42
68000020080,2969,2985,2961,2887,-98
68000020081,3837,3956,3945,3989,33
68000020082,5701,5727,5779,5750,23
68000020083,6506,6566,6571,6630,64
68000020084,4774,4882,4930,4957,75
68000020085,4850,4921,4904,4898,-23
68000030001,1774,1748,1741,1748,0
68000030002,1119,1203,1195,1162,-41
68000030003,5762,5724,5737,5704,-20
68000030004,6728,6692,6744,6676,-16
68000030005,1450,1489,1458,1442,-47
68000030006,1085,1094,1094,1075,-19
68000030007,3489,3507,3524,3519,12
68000030008,2612,2582,2531,2518,-64
68000030009,1037,1046,1009,962,-84
68000030010,921,940,918,894,-46
68000030011,1511,1562,1504,1500,-62
68000030012,2050,2046,2049,1998,-48
68000030013,3121,3213,3239,3215,2
68000030014,1754,1769,1725,1708,-61
68000030015,3436,3475,3437,3433,-42
68000030016,3034,3080,3080,3032,-48
68000030017,8484,4573,4936,5421,848
68000030018,6266,6351,6426,6369,18
68000030019,3712,3854,3941,4021,167
68000030020,1887,1893,1907,1915,22
68000030021,5950,5942,5947,6009,67
68000030022,4508,4490,4497,4454,-36
68000030023,2911,2848,2814,2866,18
68000030024,3411,3384,3643,3655,271
68000030025,5614,5420,5398,5372,-48
68000030026,4742,4759,4789,4787,28
68000030027,6083,6179,6250,6195,16
68000040001,4582,4673,4694,4790,117
68000040002,1305,1282,1291,1270,-12
68000040003,3166,3175,3130,3131,-44
68000040004,8496,8795,9004,9250,455
68000040005,3886,3843,3801,3749,-94
68000040006,3278,3295,3448,3468,173
68000040007,4940,4907,4885,4848,-59
68000040008,3085,3068,3029,3030,-38
68000040009,2422,2443,2408,2357,-86
68000040010,4033,4054,4029,4066,12
68000040011,1652,1654,1649,1590,-64
68000040012,1386,1403,1424,1690,287
68000040013,6682,6859,7021,7167,308
68000040014,5295,5351,5388,5528,177
68000040015,4529,4660,5074,5119,459
68000040016,4615,4614,4621,4618,4
68000040017,4045,4133,4205,4225,92
68000040018,4576,4565,4526,4454,-111
68000040019,3794,3755,3775,3720,-35
68000040020,2185,2165,2183,2128,-37
68000040021,4596,4596,4642,4600,4
68000040022,3230,3247,3338,3410,163
68000040023,4506,4471,4407,4441,-30
68000040024,3163,3229,3212,3277,48
68000040025,6235,6378,6609,6744,366
68000040026,3738,3793,3791,3758,-35
68000040027,7578,8330,8997,9573,1243
68000040028,4751,4832,5048,5121,289
68000040029,3916,3946,3918,3923,-23
68000040030,3968,4016,3981,3990,-26
68000040031,4561,4628,4972,5231,603
68000040032,4400,4429,4370,4295,-134
68000040033,4031,4095,4132,4108,13
68000040034,6976,7171,7336,7548,377
68000040035,2232,2284,2330,2313,29
68000040036,4320,4546,4582,4639,93
68000040037,3271,3268,3274,3309,41
68000040038,3399,3453,3472,3498,45
68000040039,2847,2932,3005,3040,108
68000040040,4480,4509,4518,4579,70
68000040041,3489,3533,3530,3547,14
68000050001,3424,3383,3396,3471,88
68000050002,4545,4683,4892,4952,269
68000050003,5699,5928,6043,6099,171
68000050004,5675,6033,6199,6275,242
68000050006,4859,4827,4838,4785,-42
68000050007,4277,4330,4394,4362,32
68000050008,4772,4774,4891,4854,80
68000050009,3017,3035,3038,3034,-1
68000050010,2994,2990,2995,3037,47
68000050011,2038,2071,2040,2053,-18
68000050012,4371,4311,4294,4265,-46
68000050013,1758,1777,1777,1767,-10
68000050014,1960,1961,1934,1899,-62
68000050015,2996,3001,3037,3003,2
68000050016,6597,3616,3632,3649,33
68000050017,3871,3912,4067,4330,418
68000050018,6622,6733,6746,6705,-28
68000050019,3158,3186,3177,3103,-83
68000050020,3895,3950,3943,3908,-42
68000050021,1573,1588,1559,1577,-11
68000050022,4251,4364,4386,4341,-23
68000050023,3594,3615,3610,3557,-58
68000050024,3928,3999,4134,4131,132
68000050025,5781,5946,6052,6115,169
68000050026,5649,5754,5845,5976,222
68000050027,4595,4752,4877,5116,364
68000050028,6566,6532,6542,6481,-51
68000050029,9982,4589,4646,4573,-16
68000050030,2083,2033,2048,2051,18
68000050031,7132,7151,7179,7183,32
68000050032,4608,4668,4729,4770,102
68000050033,3967,4104,4191,4190,86
68000050034,4127,4147,4145,4157,10
68000050035,3535,3558,3584,3578,20
68000050036,5913,6260,6539,6649,389
68000050037,4084,4126,4163,4250,124
68000050038,4016,4119,4214,4176,57
68000060001,7594,7538,7528,7480,-58
68000060002,7963,8200,8467,8611,411
68000060003,5547,5601,5622,5556,-45
68000060004,1869,1891,1857,1867,-24
68000060005,11931,12724,13894,14540,1816
68000060006,5849,5882,6038,6201,319
68000060007,7204,7184,7188,7200,16
68000060008,1920,1994,2003,1988,-6
68000060010,3591,3545,3553,3466,-79
68000060011,8438,8427,8579,8636,209
68000060012,3809,3923,3956,3920,-3
68000060013,2204,2265,2272,2229,-36
68000060014,3184,3222,3190,3046,-176
68000060015,2968,3026,3111,3095,69
68000060016,3080,3066,3104,3090,24
68000060017,2582,2624,2597,2569,-55
68000060018,3172,3248,3352,3404,156
68000060019,6376,6528,6767,6989,461
68000070001,7220,4556,4548,4812,256
68000070002,8242,8191,8202,8092,-99
68000070003,5242,5267,5308,5315,48
68000070004,7066,7157,7168,7128,-29
68000070005,3779,3862,3951,3894,32
68000070006,6426,6521,6505,6514,-7
68000070007,4187,4169,4139,4129,-40
68000070008,7303,6467,6560,6589,122
68000070009,1354,1359,1364,1460,101
68000070010,11125,4273,4348,4544,271
68000070011,2222,2233,2258,2251,18
68000070012,2305,2305,2308,2334,29
68000070013,5726,5658,5660,5585,-73
68000070014,5695,5586,5693,5594,8
68000070015,6494,6519,6435,6332,-187
68000070016,4735,4696,4695,4725,29
68000070017,2025,2007,2035,2034,27
68000070018,2817,2850,2938,2968,118
68000070019,4748,4866,4872,4851,-15
68000070020,7246,7611,8074,8379,768
68000070021,2929,2963,3014,2964,1
68000070022,6128,6213,6318,6334,121
68000070023,2385,2373,2378,2313,-60
68000070024,3697,3825,3870,3879,54
68000070025,6587,6785,6847,6908,123
68000070026,4653,4610,4626,4569,-41
68000070027,6119,6337,6446,6480,143
68000070028,10968,11253,11454,11442,189
68000070029,4820,4962,5109,5595,633
68000070030,3390,3415,3364,3417,2
68000080001,8093,8954,9717,11121,2167
68000080002,9411,10492,11691,12299,1807
68000080003,4093,4604,5288,5865,1261
68000080004,3882,3862,3830,3784,-78
68000080005,4280,4244,4298,4206,-38
68000080006,3911,3927,3901,3849,-78
68000080007,3897,3902,3882,3801,-101
68000080008,5256,5401,5460,5492,91
68000080009,4046,4060,4062,4192,132
68000080010,2490,2541,2643,2653,112
68000080011,3107,3112,3133,3085,-27
68000080012,4576,4630,4642,4588,-42
68000080013,3806,3790,3783,3701,-89
68000080014,4556,4583,4617,4646,63
68000080015,4063,4121,4160,4172,51
68000080016,4526,4564,4625,4724,160
68000080017,8481,8802,9082,9154,352
68000080018,1801,1801,1800,1805,4
68000080019,3975,3986,3963,4011,25
68000080020,4559,4538,4488,4492,-46
68000080021,2338,2368,2381,2347,-21
68000080022,6339,6409,6413,6433,24
68000080023,4870,4861,4965,5146,285
68000080024,4261,4168,4187,4130,-38
68000080025,2992,3081,3112,3170,89
68000080026,5048,5117,5086,5091,-26
68000080027,4599,4854,4969,5044,190
68000080028,5051,5062,5053,5022,-40
68000080029,3390,3430,3427,3407,-23
68000080030,5063,5031,5003,5483,452
68000080031,3673,3703,3714,3684,-19
68000080032,2372,2362,2360,2372,10
68000080033,4314,4347,4390,4366,19
68000080034,1793,1802,1821,1778,-24
68000080035,1712,1694,1671,1664,-30
68000080036,2737,2742,2725,2748,6
68000080037,2349,2363,2371,2366,3
68000080038,5389,5482,5586,5744,262
68000080039,3761,3752,3732,3741,-11
68000080040,3133,3204,3219,3311,107
68000080041,3099,3161,3192,3203,42
68000080042,4653,4911,5142,5256,345
68000080043,4674,4737,4797,4755,18
68000080044,3127,3146,3146,3072,-74
68000080045,2645,2628,2640,2595,-33
68000080046,5309,5275,5270,5252,-23
68000080047,3438,3416,3411,3323,-93
68000080048,3136,3178,3126,3059,-119
68000090001,5494,5565,5617,5604,39
68000090002,6696,6966,7031,7117,151
68000090003,4681,4783,4876,5109,326
68000090004,3730,3735,3744,3667,-68
68000090006,4313,4369,4408,4419,50
68000090007,4794,4826,4852,4883,57
68000090008,770,762,766,760,-2
68000090009,5192,5259,5319,5329,70
68000090010,7053,7137,7083,7140,3
68000090011,2238,2261,2259,2236,-25
68000090012,5225,5272,5317,5335,63
68000090013,4322,4323,4364,4420,97
68000090014,5138,5185,5119,5043,-142
68000090015,4139,4165,4137,4108,-57
68000090016,2755,2821,2868,2962,141
68000090017,1734,1752,1763,1709,-43
68000090018,2400,2471,2544,2537,66
68000090019,3494,3507,3564,3609,102
68000090020,3382,3351,3388,3350,-1
68000090021,2764,2845,3060,3124,279
68000090022,5029,5123,5144,5156,33
68000090023,4234,4259,4263,4195,-64
68000090024,3553,3561,3580,3554,-7
68000090025,5049,5181,5209,5230,49
68000090026,4035,4087,4100,4021,-66
68000090027,3338,1816,1791,1773,-43
68000090028,4896,4768,4762,4846,78
68000090029,2788,2783,2783,2761,-22
68000090030,4488,4480,4418,4424,-56
68000090031,4098,4051,4096,4079,28
68000100001,5805,5774,5756,5703,-71
68000100002,5161,5128,5186,5226,98
68000100003,6803,6840,6957,6916,76
68000100004,6658,6707,6760,6668,-39
68000100005,6243,6296,6329,6386,90
68000100006,4604,4723,5027,5232,509
68000100007,4400,4368,4485,4531,163
68000100008,7638,7718,7769,7774,56
68000100009,2922,2917,2925,2914,-3
68000100010,4948,4897,4804,4745,-152
68000100011,4873,4915,4926,4846,-69
68000100012,5279,5332,5299,5263,-69
68000100013,7033,7089,7074,7072,-17
68000100014,5346,5373,5368,5427,54
68000100015,2764,2771,2797,2801,30
68000100016,6457,6443,6401,6254,-189
68000100017,3378,3353,3326,3311,-42
68000100018,4017,3959,3925,3877,-82
68000100019,3177,3202,3193,3101,-101
68000100020,2527,2556,2527,2514,-42
68000100021,1260,1435,1516,1608,173
68000100022,2042,2094,2095,2059,-35
68000100023,5053,5012,5015,4992,-20
68000100024,6501,6442,6404,6329,-113
68000100025,3341,3364,3349,3305,-59
68000100026,5013,5274,5313,5315,41
68000100027,3550,3552,3571,3589,37
68000100028,8040,7999,8439,8676,677
68000100029,2140,2159,2168,2125,-34
68000100030,5436,5499,5532,5588,89
68000100031,4503,4576,4595,4565,-11
68000100032,3913,3918,3966,4080,162
68000100033,7395,7901,8264,8515,614
68000100034,5176,5125,5113,4953,-172
68000100035,3699,3720,3675,3642,-78
68000100036,4592,4556,4585,4599,43
68000100037,5970,6032,6152,6156,124
68000100038,5271,5212,5219,5191,-21
68000100039,3420,3521,3563,3576,55
68000100040,1923,1924,1900,1892,-32
68000100041,4567,4608,4706,4747,139
68000100042,6383,6456,6455,6345,-111
68000100043,6828,7020,7014,6962,-58
68000100044,4297,4464,4541,4632,168
68000100045,5783,5967,6259,6338,371
68000100046,8090,8221,8193,8271,50
68000110001,3518,3495,3517,3506,11
68000110002,4969,4996,4965,4942,-54
68000110003,1865,1844,1876,1847,3
68000110004,4704,4811,4821,4836,25
68000110005,4809,4963,5161,5382,419
68000110006,3025,3010,2963,3024,14
68000110007,2726,2713,2686,2676,-37
68000110008,1592,1612,1589,1563,-49
68000110009,1674,1673,1705,1748,75
68000110010,2331,2380,2479,2504,124
68000110011,822,816,796,805,-11
68000110012,1993,1986,1970,1968,-18
68000110013,1049,1062,1028,1020,-42
68000110014,1569,1560,1528,1506,-54
68000110015,1133,1126,1137,1146,20
68000110016,2586,2559,2541,2497,-62
68000110017,1163,1192,1178,1146,-46
68000110018,742,748,726,726,-22
68000110019,1030,1059,1069,1033,-26
68000110020,1263,1252,1218,1215,-37
68000110021,1249,1245,1233,1224,-21
68000110022,1534,1511,1495,1472,-39
68000110023,1607,1597,1575,1547,-50
68000120001,3326,3301,3264,3319,18
68000120002,1260,1148,1096,1035,-113
68000120003,1629,1648,1582,1543,-105
68000120004,1953,1986,2084,2159,173
68000120005,1060,1071,1069,1075,4
68000120006,2441,2495,2574,2582,87
68000120007,966,1001,957,966,-35
68000120008,809,807,803,797,-10
68000120009,1859,1900,1983,2090,190
68000120010,3109,3161,3130,3107,-54
68000120011,2948,2935,2961,3017,82
68000120012,3888,3868,3838,3855,-13
68000120013,1780,1765,1754,1767,2
68000120014,5683,5694,5683,5599,-95
68000120015,4602,4607,4552,4684,77
68000120016,2728,2767,2815,2820,53
68000120017,3513,3586,3625,3622,36
68000120018,2907,2970,2964,2960,-10
68000120019,1247,1258,1264,1215,-43
68000120020,2465,2432,2416,2392,-40
68000120021,2308,2589,2907,3471,882
68000120022,4555,4852,5074,5361,509
68000120023,2420,2386,2371,2343,-43
68000120024,7016,7131,7190,7253,122
68000130001,2318,2392,2437,2472,80
68000130002,1641,1684,1706,1725,41
68000130003,852,919,930,946,27
68000130004,663,702,723,737,35
68000130005,781,818,815,800,-18
68000130006,825,860,895,883,23
68000130007,856,961,958,985,24
68000130008,1457,1496,1512,1537,41
68000130009,1212,1242,1259,1279,37
68000130010,900,952,941,990,38
66000010001,1888,1900,1867,1818,-82
66000010002,2750,2697,2657,2646,-51
66000010003,2089,2071,2076,2002,-69
66000010004,1776,1793,1761,1768,-25
66000010005,2513,2520,2493,2440,-80
66000010006,2202,2244,2237,2253,9
66000010007,2903,2920,2945,2914,-6
66000010008,2329,2369,2354,2327,-42
66000020001,3652,3586,3552,3509,-77
66000020002,3659,3627,3616,3525,-102
66000020003,4276,4320,4399,4417,97
66000020004,3331,3291,3276,3279,-12
66000020005,2280,2225,2155,2143,-82
66000020006,2084,2237,2254,2320,83
66000020007,2912,2856,2825,2903,47
66000020008,2560,2594,2605,2572,-22
66000020009,7765,7921,7949,7902,-19
66000020010,5373,5583,5604,5622,39
66000020011,4428,4407,4323,4256,-151
66000020012,3090,3078,3062,3116,38
66000020013,4971,4865,4808,4799,-66
66000020014,1936,1937,1931,1931,-6
66000020015,4752,4712,4667,4634,-78
66000020016,10663,10647,10568,10650,3
66000020017,8079,8289,8349,8335,46
66000030001,4162,4153,4112,4043,-110
66000030002,4436,4419,4418,4353,-66
66000030003,4046,3993,3986,3958,-35
66000030004,3205,3243,3259,3252,9
66000030005,2951,2936,2890,2855,-81
66000030006,3229,3185,3186,3175,-10
66000030007,5436,5438,5451,5483,45
66000030008,4436,4504,4515,4455,-49
66000030009,6349,6327,6273,6224,-103
66000030010,4632,4665,4621,4906,241
66000030011,9397,9558,9585,9565,7
66000030012,13704,13977,14543,14742,765
66000030013,9544,9800,10066,10060,260
66000030014,5212,5187,5181,5089,-98
66000030015,2342,2275,2211,2171,-104
66000030016,3067,3024,3004,2973,-51
66000030017,6360,6470,6479,6430,-40
66000030018,4118,4103,4066,4066,-37
66000030019,8437,8524,8555,8678,154
66000030020,5331,5267,5214,5410,143
66000030021,8029,8148,8259,8184,36
66000030022,6644,6678,6697,6697,19
66000040001,2694,2623,2598,2627,4
66000040002,2135,2087,2068,2013,-74
66000040003,3184,3131,3031,3101,-30
66000040004,2898,2895,2893,2835,-60
66000040005,1910,1868,1786,1712,-156
66000040006,2554,2556,2537,2506,-50
66000040007,5510,5547,5585,5518,-29
66000040008,5071,5056,4968,4944,-112
66000040009,6697,6775,6773,6639,-136
66000040010,2704,2717,2685,2601,-116
66000040011,3828,3872,3923,4007,135
66000040012,4225,4279,4297,4286,7
66000040013,3312,3290,3258,3258,-32
66000040014,7761,7757,7676,7604,-153
66000040015,6620,6667,6569,6636,-31
66000040016,6791,6744,6787,6709,-35
66000040017,7550,7578,7676,7612,34
66000040018,6661,6612,6627,6640,28
66000040019,6717,6685,6641,6566,-119
66000040020,3260,3294,3239,3193,-101
66000040021,4273,4229,4167,4147,-82
66000040022,5775,5817,5858,5958,141
66000040023,5071,5123,5135,5075,-48
66000040024,3237,3238,3180,3166,-72
66000040025,5189,5258,5316,5230,-28
66000050001,2362,2344,2315,2325,-19
66000050002,3856,3811,3795,3755,-56
66000050003,1654,1662,1618,1590,-72
66000050004,1722,1715,1686,1640,-75
66000050005,1929,1907,1882,1867,-40
66000050006,3002,2945,2893,2818,-127
66000050007,3727,3666,3621,3600,-66
66000050008,6382,6398,6484,6447,49
66000050009,3947,3909,3862,3812,-97
66000050010,2883,2925,2929,2965,40
66000050011,4983,4962,4942,4903,-59
66000050012,2676,2735,2744,2726,-9
66000050013,6657,6603,6587,6490,-113
66000050014,4883,4860,4823,4785,-75
66000050015,6212,6124,6116,6079,-45
66000050016,5260,5193,5125,5020,-173
66000050017,4244,4267,4217,4207,-60
66000050018,5879,5917,6010,6009,92
66000050019,3127,3113,3094,3052,-61
66000050020,4355,4407,4813,5083,676
66000050021,7784,7773,7699,7673,-100
66000050022,6270,6294,6257,6245,-49
66000050023,7231,7273,7205,7128,-145
66000050024,4525,4491,4539,4540,49
66000050025,4604,4584,4518,4488,-96
66000050026,2005,1976,1968,1876,-100
66000050027,1917,1918,1904,1929,11
66000050028,2489,2488,2442,2417,-71
66000050029,2164,2128,2062,2111,-17
66000050030,3928,3893,3820,3771,-122
66000050031,4158,4170,4120,4054,-116
66000050032,5152,5113,5048,5007,-106
66000050033,3156,3155,3168,3124,-31
66000050034,4196,4404,4455,4415,11
66000050035,3703,3726,3890,3926,200
66000050036,4631,4708,4740,4713,5
66000060001,5923,5946,5952,6190,244
66000060002,6515,6881,7161,7492,611
66000060003,6341,6475,6957,7265,790
66000060004,951,995,1019,1027,32
66000060005,17364,17929,18652,19312,1383
66000060006,6155,6281,6371,6423,142
66000060007,5249,5212,5192,5156,-56
66000060008,3253,3198,3145,3065,-133
66000060009,6149,6088,6086,6030,-58
66000060010,3857,3847,3828,3828,-19
66000060011,4566,4557,4526,4463,-94
66000060012,2454,2461,2435,2449,-12
66000060013,3750,3723,3707,3774,51
66000060014,5663,5610,5655,5572,-38
66000060015,6060,6114,6151,6094,-20
66000060016,3004,2952,2895,2865,-87
66000060017,4302,4295,4371,4325,30
66000060018,15849,16108,16294,16419,311
66000060019,3364,3435,3514,3626,191
66000060020,5518,5553,5548,5584,31
66000060021,7430,7394,7300,7192,-202
66000060022,4397,4351,4300,4276,-75
66000060023,7841,7760,7734,7713,-47
66000060024,6142,6057,6100,5935,-122
66000060025,4947,4951,4902,4886,-65
66000060026,5261,5322,5346,5330,8
66000060027,6335,6414,6487,6454,40
66000060028,4951,4988,4979,4956,-32
66000060029,6615,6597,6593,6400,-197
66000060030,4291,4211,4214,4214,3
66000060031,8549,8616,8591,8575,-41
66000060032,5148,5119,5099,5084,-35
66000060033,5088,5128,5141,5066,-62
66000060034,3836,3849,3824,3782,-67
66000060035,5631,5740,5713,5739,-1
66000060036,3899,3939,3990,4049,110
66000060037,3858,3853,3850,3862,9
66000060038,9169,9268,9464,9765,497
66000060039,7368,7413,7415,7493,80
66000070001,10844,10883,11020,10999,116
66000070002,13126,13382,13536,13671,289
66000070003,7062,7154,7171,7137,-17
66000070004,5301,5255,5191,5097,-158
66000070005,7492,7591,7573,7547,-44
66000070006,923,973,941,1343,370
66000070007,12159,12487,13283,14252,1765
66000070008,1413,1793,2260,2617,824
66000070009,5884,5966,6178,6299,333
66000070010,8808,8748,8756,9002,254
66000070011,6464,6645,6762,6768,123
66000070012,7549,7561,7687,7746,185
66000070013,5136,5033,5006,4921,-112
66000070014,1714,1660,1628,1554,-106
66000070015,5753,5767,5838,5920,153
66000070016,4631,4671,4733,4790,119
66000070017,6306,6372,6343,6391,19
66000070018,6281,6335,6437,6465,130
66000070019,4255,4248,4241,4256,8
66000070020,5265,5374,5484,5492,118
66000070021,7911,7990,8109,8115,125
66000070022,9183,9363,9547,9752,389
66000070023,6376,6439,6510,6549,110
66000070024,10612,10600,10912,10949,349
66000070025,8312,8328,8386,8430,102
66000080001,3808,3745,3706,3631,-114
66000080002,3902,3923,3973,3935,12
66000080003,8335,8341,8272,8235,-106
66000080004,6570,6692,6780,6857,165
66000080005,6311,6233,6231,6255,22
66000080006,5297,5290,5291,5318,28
66000080007,7102,7121,7126,7714,593
66000080008,16534,16689,17071,17112,423
66000080009,14796,15035,15361,15393,358
66000080010,12529,13297,14061,14562,1265
66000080011,2414,2446,2409,2425,-21
66000080012,1154,1177,1181,1202,25
66000080013,11120,13333,15474,17088,3755
66000080014,2452,2431,2424,2472,41
66000080015,1040,1049,1041,1044,-5
66000080016,10202,10250,10533,10892,642
66000080017,10697,10839,10894,11016,177
66000080018,10192,10711,11173,12289,1578
66000080019,1979,1959,1915,1887,-72
66000080020,11512,11694,11747,11701,7
66000080021,6218,6236,6217,6242,6
66000080022,1253,1204,1206,1188,-16
66000080023,7564,7701,7728,7658,-43
66000080024,5435,5410,5367,5333,-77
66000080025,4987,4914,4904,4845,-69
66000080026,6093,6135,6062,6031,-104
66000080027,3751,3762,3762,3776,14
66000080028,7524,7607,7581,7543,-64
66000080029,5814,5818,5808,5760,-58
66000080030,6131,6123,6125,6065,-58
66000080031,5760,5745,5710,5623,-122
66000080032,8121,8198,8424,8527,329
66000080033,6157,6134,6099,6053,-81
66000080034,3738,3695,3691,3688,-7
66000080035,5768,5748,5706,5757,9
66000080036,4459,4458,4462,4363,-95
66000080037,7693,7665,7646,7610,-55
66000080038,5893,5912,5909,5916,4
66000080039,7874,7941,8050,8032,91
66000080040,5192,5208,5183,5072,-136
66000080041,6750,6749,6697,6637,-112
66000080042,4698,4679,4621,4597,-82
66000090001,2657,2646,2673,2601,-45
66000090002,1042,1054,1036,1011,-43
66000090003,1018,1014,993,963,-51
66000090004,1298,1284,1321,1277,-7
66000090005,881,877,863,843,-34
66000090006,905,874,831,826,-48
66000090007,795,774,753,732,-42
66000090008,1863,1845,1826,1825,-20
66000090009,6293,6182,6071,5977,-205
66000090010,2715,2716,2711,2697,-19
66000090011,1815,1802,1791,1761,-41
66000090012,1455,1425,1415,1388,-37
66000090013,2966,2972,2930,2862,-110
66000090014,3440,3380,3381,3319,-61
66000090015,4961,4943,4864,4805,-138
66000090016,10968,11047,11146,11202,155
66000090017,1426,1454,1448,1447,-7
66000090018,3761,3915,3882,3889,-26
66000090019,11864,11908,11942,11801,-107
66000090020,7534,7605,7572,7555,-50
66000090021,3464,3488,3472,3420,-68
66000090022,7523,7441,7421,7357,-84
66000090023,12330,12315,12293,12251,-64
66000090024,5619,5610,5559,5578,-32
66000090025,13340,13577,13816,13779,202
66000090026,3549,3476,3468,3456,-20
66000090027,16151,16156,16116,16053,-103
66000090028,6975,6849,6787,6810,-39
66000090029,1861,1874,1855,1851,-23
66000090030,6373,6391,6480,6428,37
66000090031,3790,3784,3776,3751,-33
66000090032,3905,3960,3912,3896,-64
66000090033,2538,2544,2567,2683,139
66000090034,3348,3418,3596,3734,316
66000090035,2455,2449,2406,2386,-63
66000090036,4001,3976,3902,3839,-137
66000100001,1615,1588,1583,1547,-41
66000100002,1001,1032,1003,990,-42
66000100003,1266,1236,1208,1184,-52
66000100004,2247,2192,2158,2087,-105
66000100005,2675,2587,2565,2530,-57
66000100006,1179,1135,1136,1133,-2
66000100007,1747,1703,1705,1709,6
66000100008,4161,4146,4136,4073,-73
66000100009,2196,2179,2140,2119,-60
66000100010,4319,4325,4367,4339,14
66000100011,1695,1678,1657,1630,-48
66000100012,5912,5829,5761,5708,-121
66000100013,1900,1914,1891,1864,-50
66000100014,1126,1121,1103,1092,-29
66000100015,970,962,948,934,-28
66000100016,2149,2127,2078,2044,-83
66000100017,1468,1462,1443,1413,-49
66000100018,2217,2239,2223,2222,-17
66000100019,2352,2344,2337,2310,-34
66000100020,1906,1881,1860,1842,-39
66000100021,1379,1355,1338,1316,-39
66000100022,2076,2101,2073,2049,-52
66000100023,824,818,787,783,-35
66000100024,751,731,712,712,-19
66000100025,1583,1571,1561,1539,-32
66000110001,1775,1762,1745,1712,-50
66000110002,1291,1279,1255,1217,-62
66000110003,1887,1853,1838,1834,-19
66000110004,1040,1007,1001,988,-19
66000110005,2736,2684,2642,2619,-65
66000110006,2599,2566,2512,2445,-121
66000110007,4230,4178,4191,4159,-19
66000110008,2603,2584,2566,2551,-33
66000110009,5189,5206,5252,5227,21
66000110010,960,965,962,937,-28
66000110011,1036,1038,1015,1020,-18
66000110012,3902,3900,3869,3950,50
66000110013,1387,1406,1385,1364,-42
66000110014,1310,1271,1264,1246,-25
66000110015,2152,2157,2131,2172,15
66000110016,6757,6771,6687,6622,-149
66000110017,2532,2536,2488,2471,-65
66000110018,2139,2113,2094,2079,-34
66000110019,1632,1667,1618,1613,-54
66000110020,5601,5623,5568,5500,-123
66000110021,1515,1524,1471,1442,-82
66000110022,5008,5014,4980,4860,-154
66000110023,3144,3119,3085,3040,-79
66000110024,6736,6835,6739,6723,-112
66000110025,1822,1816,1778,1741,-75
66000110026,1964,1974,1977,1923,-51
66000110027,1692,1693,1674,1644,-49
66000110028,1344,1317,1310,1310,-7
66000110029,1778,1767,1725,1721,-46
66000120001,1271,1255,1268,1240,-15
66000120002,1174,1153,1145,1132,-21
66000120003,2643,2607,2598,2614,7
66000120004,877,869,867,854,-15
66000120005,2262,2271,2285,2258,-13
66000120006,1921,1912,1868,1860,-52
66000120007,820,810,825,791,-19
66000120008,505,506,487,476,-30
66000120009,2810,2770,2751,2744,-26
66000120010,11895,12018,12192,12467,449
66000120011,1764,1734,1724,1690,-44
66000120012,1830,1770,1747,1741,-29
66000120013,4992,5073,5125,5165,92
66000120014,3895,3878,3907,3899,21
66000120015,2381,2375,2381,2400,25
66000120016,5679,6268,6874,7445,1177
66000120017,3340,3364,3424,3420,56
66000120018,1546,1507,1491,1483,-24
66000120019,1581,1558,1549,1532,-26
66000120020,1448,1433,1415,1397,-36
66000120021,1408,1414,1373,1366,-48
66000120022,1566,1545,1532,1529,-16
66000120023,2483,2513,2480,2389,-124
66000120024,2707,2678,2680,2665,-13
66000120025,2080,2071,2033,2029,-42
66000120026,2938,2943,2955,2928,-15
66000120027,8951,8979,9129,9082,103
66000120028,3434,3398,3327,3267,-131
66000120029,1436,1418,1400,1398,-20
66000120030,1403,1387,1362,1350,-37
66000120031,1624,1626,1630,1642,16
66000120032,1756,1759,1763,1756,-3
66000130001,1697,1701,1671,1606,-95
66000130002,2634,2624,2600,2559,-65
66000130003,1238,1248,1221,1192,-56
66000130004,648,648,638,631,-17
66000130005,3146,3190,3202,3122,-68
66000130006,5393,5380,5376,5330,-50
66000130007,6167,6327,6391,6678,351
66000130008,8394,8587,8638,8662,75
66000130009,9311,9393,9438,9314,-79
66000130010,1370,1417,1412,1373,-44
66000130011,6134,6233,6244,6271,38
66000130012,4443,4545,4584,4734,189
66000130013,2001,2010,2016,2023,13
66000130014,6071,6312,6519,6600,288
66000130015,4247,4249,4244,4228,-21
66000130016,6581,6749,6948,7069,320
66000130017,5220,5247,5273,5274,27
66000130018,2779,2780,2768,2792,12
66000130019,2531,2512,2465,2455,-57
66000130020,4251,4236,4207,4173,-63
66000130021,8389,8691,8900,9140,449
66000140001,3756,3862,4308,4359,497
66000140002,2368,2346,2353,2345,-1
66000140003,4761,4733,4677,4639,-94
66000140004,648,632,609,581,-51
66000140005,1404,1380,1380,1392,12
66000140006,977,1014,971,938,-76
66000140007,7487,7454,7507,7476,22
66000140008,6024,6113,6209,6334,221
66000140009,5408,5485,5833,6023,538
66000140010,9344,9422,9392,9510,88
66000140011,7148,7227,7234,7269,42
66000140012,2796,2794,2771,2734,-60
66000140013,2746,2726,2718,2733,7
66000140014,3126,3030,2959,2940,-90
66000150001,2352,2400,2452,2460,60
66000150002,1288,1300,1287,1253,-47
66000150003,3799,3790,3776,3742,-48
66000150004,4406,4464,4446,4378,-86
66000150005,2538,2556,2533,2536,-20
66000150006,5833,5904,5945,5914,10
66000150007,2341,2372,2342,2313,-59
66000150008,4017,4067,4081,4090,23
66000150009,4297,4255,4281,4298,43
66000150010,2984,2996,2977,2929,-67
66000150011,2646,2669,2699,2726,57
66000150012,1914,1885,1846,1822,-63
66000150013,2619,2596,2557,2520,-76
66000150014,3833,3870,3801,3803,-67
66000150015,1542,1575,1612,1612,37
66000150016,2576,2554,2566,2566,12
66000150017,2311,2318,2329,2311,-7
66000150018,3186,3204,3136,3070,-134
66000160001,3933,3901,3808,3799,-102
66000160002,2558,2591,2695,2712,121
66000160003,3092,3082,3036,3065,-17
66000160004,2633,2657,2722,2708,51
66000160005,8797,8966,9075,9225,259
66000160006,6488,6552,6499,6436,-116
66000160007,3099,3086,3099,3079,-7
66000160008,3362,3365,3338,3283,-82
66000160009,5131,5131,5178,5193,62
66000160010,8453,8451,8412,8339,-112
66000160011,3112,3084,3037,3034,-50
66000160012,3330,3325,3282,3272,-53
66000160013,2854,2804,2806,2768,-36
66000160014,5034,4995,4987,4966,-29
66000160015,2476,2490,2484,2456,-34
66000160016,1201,1231,1221,1194,-37
66000170001,13709,13409,13401,13370,-39
66000170002,1608,1556,1541,1518,-38
66000170003,2801,2780,2784,2776,-4
66000170004,12057,12199,12315,12294,95
66000170005,6526,6610,6684,6724,114
66000170006,11350,11395,11359,11208,-187
66000170007,14240,14268,14185,14181,-87
66000170008,3335,3333,3364,3338,5
66000170009,7148,7232,7309,7361,129
66000170010,5271,5335,5328,5368,33
66000170011,4673,4686,4828,4819,133
66000170012,1742,1745,1716,1689,-56
66000170013,4489,4827,4878,4988,161
66000170014,5246,5273,5282,5206,-67
66000170015,8553,8616,8612,8646,30
66000170016,5540,5688,5738,5823,135
66000180001,5342,5307,5300,5237,-70
66000180002,11398,11663,11664,11610,-53
66000180003,7524,7591,7475,7525,-66
66000180004,3893,3911,3977,4001,90
66000180005,4363,4311,4256,4221,-90
66000180006,5178,5192,5199,5176,-16
66000180007,6492,6501,6447,6429,-72
66000180008,5935,5880,5828,5852,-28
66000180009,7525,7512,7523,7569,57
66000180010,7341,7353,7387,7313,-40
66000180011,5656,5694,5729,5769,75
66000180012,7077,7295,7368,7321,26
66000180013,7098,7235,7218,7256,21
66000180014,5910,5906,5998,6091,185
66000180015,4471,4464,4403,4323,-141
66000190001,3943,3939,3960,3960,21
66000190002,2288,2271,2228,2195,-76
66000190003,1659,1636,1629,1604,-32
66000190004,1213,1214,1205,1175,-39
66000190005,1380,1358,1334,1317,-41
66000190006,2177,2177,2139,2149,-28
66000190007,3497,3466,3439,3432,-34
66000190008,669,649,634,621,-28
66000190009,3455,3470,3402,3359,-111
66000190010,1455,1438,1408,1398,-40
66000190011,1005,992,971,957,-35
66000190012,686,660,642,639,-21
66000190013,1327,1306,1298,1258,-48
66000200001,1497,1499,1466,1458,-41
66000200002,1765,1804,1795,1770,-34
66000200003,1442,1408,1398,1410,2
66000200004,1461,1458,1432,1431,-27
66000200005,753,752,742,724,-28
66000200006,1731,1701,1689,1664,-37
66000200007,2156,2122,2100,2091,-31
66000200008,1166,1163,1140,1135,-28
66000200009,1700,1674,1625,1618,-56
66000200010,1395,1375,1371,1369,-6
66000210001,1210,1243,1264,1248,5
66000210002,2666,2678,2656,2655,-23
66000210003,2250,2216,2179,2168,-48
66000210004,5613,5659,5677,5688,29
66000210005,3998,4014,4005,3933,-81
66000210006,7558,7595,7683,7649,54
66000210007,1635,1626,1621,1595,-31
66000210008,1429,1453,1449,1428,-25
66000210009,2518,2473,2459,2428,-45
66000210010,1898,1879,1868,1808,-71
66000210011,1410,1394,1363,1340,-54
66000220001,1244,1235,1197,1197,-38
66000220002,1196,1196,1171,1147,-49
66000220003,3113,3109,3126,3093,-16
66000220004,1838,1812,1781,1735,-77
66000220005,1348,1338,1327,1343,5
66000220006,1426,1445,1448,1432,-13
66000220007,1067,1054,1040,1000,-54
66000220008,2087,2062,2048,2024,-38
66000220009,1210,1208,1209,1188,-20
66000220010,1655,1654,1619,1575,-79
66000220011,2070,2067,2054,2030,-37
66000220012,1049,1087,1091,1100,13
66000230001,10015,10102,10200,10193,91
66000230002,2975,2988,2958,2909,-79
66000230003,5629,5724,5947,6749,1025
66000230004,5523,6016,6455,6948,932
66000230005,2787,2903,3011,2980,77
66000230006,16310,16252,16245,16149,-103
66000230007,9430,9564,9591,9571,7
66000230008,2759,2616,2045,1975,-641
66000230009,1923,1925,1940,1916,-9
66000230010,2548,2551,2487,2472,-79
66000230011,2556,2583,2559,2549,-34
66000230012,5216,5210,5182,5136,-74
66000230013,2428,2475,2511,2508,33
66000230014,1942,1926,1938,1927,1
66000230015,1546,1553,1573,1565,12
66000230016,967,984,968,947,-37
66000240001,5206,5200,5135,5084,-116
66000240002,1045,1029,1022,1007,-22
66000240003,4344,4298,4234,4190,-108
66000240004,1732,1736,1716,1717,-19
66000240005,2935,2903,2870,2854,-49
66000240006,3150,3116,3051,3036,-80
66000240007,3675,3722,3686,3663,-59
66000240008,2596,2603,2627,2628,25
66000240009,1008,989,966,942,-47
66000240010,2011,1972,1984,1976,4
66000240011,2005,2018,2004,1984,-34
66000240012,1123,1133,1125,1111,-22
66000240013,1588,1577,1575,1555,-22
66000240014,8992,9093,9128,9080,-13
66000240015,6026,6075,6137,6047,-28
66000240016,5747,5780,5765,5861,81
66000240017,4139,4080,4060,4042,-38
66000250001,3688,3689,3622,3594,-95
66000250002,3392,3371,3375,3398,27
66000250003,2307,2256,2227,2197,-59
66000250004,4155,4146,4227,4384,238
66000250005,1225,1204,1218,1207,3
66000250006,2679,2702,2667,2647,-55
66000250007,6171,6126,6082,6033,-93
66000250008,3584,3510,3466,3520,10
66000250009,5991,6108,6094,6020,-88
66000250010,7076,7073,7027,7019,-54
66000250011,8901,8950,9060,9109,159
66000250012,3214,3173,3121,3112,-61
66000250013,7565,7568,7634,7728,160
66000250014,1964,1938,1909,1866,-72
66000250015,5644,5678,5725,5659,-19
66000250016,10262,10506,10573,10602,96
66000260001,1446,1412,1408,1412,0
66000260002,10737,10801,10766,10796,-5
66000260003,5504,5557,5494,5477,-80
66000260004,2718,2713,2697,2663,-50
66000260005,2322,2329,2366,2369,40
66000260006,1448,1427,1443,1432,5
66000260007,1271,1270,1259,1228,-42
66000260008,7008,6975,7009,6956,-19
66000260009,3520,3505,3492,3488,-17
66000260010,4689,4704,4755,4696,-8
66000260011,2246,2281,2249,2231,-50
66000260012,2798,2823,2855,2847,24
66000260013,3016,2989,2972,3064,75
66000260014,3144,3193,3142,3054,-139
66000260015,2483,2496,2460,2404,-92
66000260016,1327,1318,1301,1297,-21
66000260017,2825,2888,2878,2864,-24
66000260018,2708,2759,2742,2708,-51
66000260019,2612,2617,2576,2564,-53
66000260020,1571,1562,1555,1544,-18
66000270001,6640,6560,6568,6455,-105
66000270002,7209,7236,7397,7661,425
66000270003,5000,4972,4956,4916,-56
66000270004,3958,3925,3894,3821,-104
66000270005,3438,3425,3429,3357,-68
66000270006,5084,5055,5074,4999,-56
66000270007,7303,7320,7253,7203,-117
66000270008,4207,4140,4152,4164,24
66000270009,3828,3828,3817,3825,-3
66000270010,6015,6024,6050,5986,-38
66000270011,8962,9086,9391,9455,369
66000270012,8538,8817,8994,9216,399
66000270013,6973,7473,7946,8099,626
66000270014,2133,2133,2087,2026,-107
66000270015,1339,1349,1347,1327,-22
66000270016,3854,3813,3886,3876,63
66000270017,3765,3830,3761,3739,-91
66000270018,5841,5814,5814,5764,-50
66000270019,720,748,718,699,-49
66000270020,8097,8173,8264,8347,174
66000270021,4913,4934,4845,4783,-151
66000270022,4728,4728,4746,4695,-33
66000270023,3374,3398,3457,3440,42
66000270024,4468,4450,4440,4427,-23
66000270025,2708,2731,2689,2609,-122
66000270026,3461,3423,3400,3374,-49
66000270027,5890,6297,6790,7088,791
66000270028,7799,8828,9336,10448,1620
66000270029,6682,6871,6937,6890,19
66000270030,6379,6617,6760,6932,315
66000270031,7143,7129,7172,7155,26
66000270032,4471,4466,4454,4430,-36
66000270033,4336,4379,4418,4434,55
66000270034,5141,5152,5071,5037,-115
66000270035,2940,2913,2880,2861,-52
66000270036,2544,2574,2531,2452,-122
66000270037,1824,1800,1755,1743,-57
66000270038,4304,4274,4221,4213,-61
66000270039,3057,3067,3029,3024,-43
66000280001,4144,4112,4188,4254,142
66000280002,12213,12196,12446,12615,419
66000280003,4404,4426,4536,4660,234
66000280004,8537,8486,8352,8218,-268
66000280005,8073,8214,8264,8393,179
66000280006,4688,4794,4824,4990,196
66000280007,6864,6759,6786,6730,-29
66000280008,9940,10010,10086,10077,67
66000280009,4077,4077,4107,4132,55
66000280010,6348,6330,6318,6341,11
66000280011,9006,9094,9163,9191,97
66000280012,5203,5201,5157,5058,-143
66000280013,1156,1158,1149,1126,-32
66000280014,10464,10516,10504,10423,-93
66000280015,5212,5209,5238,5452,243
66000280016,10041,10102,10048,9941,-161
66000280017,14375,14283,14308,14269,-14
66000280018,11847,11880,11783,11696,-184
66000280019,12194,12203,12264,12294,91
66000280020,3506,3506,3477,3391,-115
66000280021,7155,7091,7033,6978,-113
66000280022,5012,4931,4877,4912,-19
66000280023,12848,13146,13442,13639,493
66000280024,10706,10771,10818,10840,69
66000280025,6570,6665,6641,6666,1
66000280026,9423,9493,9441,9427,-66
66000280027,7486,7451,7461,7404,-47
66000290001,2214,2164,2142,2119,-45
66000290002,486,482,469,481,-1
66000290003,1963,1931,1919,1902,-29
66000290004,518,510,519,516,6
66000290005,1241,1251,1253,1242,-9
66000290006,1316,1341,1333,1326,-15
66000290007,2257,2315,2254,2209,-106
66000290008,954,1021,1013,1014,-7
67000010001,5546,5443,5368,5350,-93
67000010002,2899,2836,2822,2756,-80
67000010003,3358,3331,3314,3272,-59
67000010004,861,,,,0
67000010005,1230,,,,0
67000010006,1109,,,,0
67000010007,3743,3680,3635,3573,-107
67000010008,5286,5258,5140,5049,-209
67000010009,1420,1418,1395,1352,-66
67000010010,1681,1646,1638,1631,-15
67000010011,430,,,,0
67000010012,2853,2809,2738,2697,-112
67000010013,1653,2051,2016,2024,-27
67000010014,3820,3806,3746,3681,-125
67000010015,5260,5220,5213,5160,-60
67000010016,1990,1989,1939,1912,-77
67000010017,1600,1571,1566,1547,-24
67000010018,1665,1945,1890,1887,-58
67000010019,1971,2004,1982,1940,-64
67000010020,4350,4323,4299,4237,-86
67000010021,2156,2190,2195,2206,16
67000010022,340,,,,0
67000010023,440,,,,0
67000010024,812,,,,0
67000010025,1055,1842,1789,1763,-79
67000010026,595,1050,1021,1004,-46
67000010027,5616,5665,5756,5781,116
67000010028,6049,6097,6116,6143,46
67000010029,8178,8315,8337,8391,76
67000020001,1783,1799,1790,1729,-70
67000020002,752,,,,0
67000020003,366,,,,0
67000020004,585,,,,0
67000020005,584,,,,0
67000020006,364,,,,0
67000020007,879,,,,0
67000020008,4354,4360,4348,4331,-29
67000020009,894,,,,0
67000020010,1037,1022,994,984,-38
67000020011,4308,4318,4398,4500,182
67000020012,979,,,,0
67000020013,835,,,,0
67000020014,1912,1896,1865,1853,-43
67000020015,567,,,,0
67000020016,335,,,,0
67000020017,715,,,,0
67000020018,463,,,,0
67000020019,838,,,,0
67000020020,430,,,,0
67000020021,244,,,,0
67000020022,343,,,,0
67000020023,441,,,,0
67000020024,547,,,,0
67000020025,1028,,,,0
67000030001,1947,1911,1890,1894,-17
67000030002,3430,3455,3513,3496,41
67000030003,1637,1602,1572,1577,-25
67000030004,1897,1880,1875,1850,-30
67000030005,1033,1039,1019,1005,-34
67000030006,1486,1484,1479,1443,-41
67000030007,494,490,472,476,-14
67000030008,665,652,636,620,-32
67000030009,420,417,402,396,-21
67000030010,576,562,547,542,-20
67000030011,1451,1405,1352,1298,-107
67000030012,1174,1139,1109,1072,-67
67000030013,1386,,,,0
67000030014,1675,1652,1616,1568,-84
67000030015,955,,,,0
67000030016,715,,,,0
67000030017,996,,,,0
67000030018,1001,989,963,941,-48
67000030019,816,823,798,781,-42
67000030020,1580,1530,1514,1494,-36
67000030021,826,818,803,800,-18
67000030022,769,760,749,718,-42
67000030023,942,,,,0
67000030024,649,,,,0
67000040001,2021,2048,2100,2094,46
67000040002,2093,1774,1740,1774,0
67000040003,944,1266,1267,1269,3
67000040004,3152,3073,3120,3079,6
67000040005,1517,1578,1593,1565,-13
67000040006,840,849,822,798,-51
67000040007,1676,1655,1646,1610,-45
67000040008,2083,2034,1984,1954,-80
67000040009,1461,1435,1434,1410,-25
67000040010,732,723,727,715,-8
67000040011,1616,1585,1539,1509,-76
67000040012,1361,1348,1331,1328,-20
67000040013,1869,1837,1765,1721,-116
67000050001,1887,1851,1818,1803,-48
67000050002,1563,1519,1498,1475,-44
67000050003,1475,1465,1457,1460,-5
67000050004,1485,1485,1454,1466,-19
67000050005,1255,,,,0
67000050006,1330,,,,0
67000050007,836,,,,0
67000050008,515,,,,0
67000050009,601,,,,0
67000050010,1579,1564,1524,1488,-76
67000050011,1876,1865,1839,1815,-50
67000050012,1431,1434,1422,1404,-30
67000050013,1328,1337,1339,1345,8
67000050014,1343,1997,1975,1933,-64
67000050015,771,,,,0
67000050016,477,,,,0
67000050017,766,,,,0
67000050018,419,1597,1555,1525,-72
67000050019,1127,1101,1077,1066,-35
67000050020,546,,,,0
67000050021,1108,,,,0
67000060001,1604,1592,1566,1577,-15
67000060002,2872,2898,2911,2887,-11
67000060003,1676,1651,1600,1577,-74
67000060004,1054,1061,1051,1035,-26
67000060005,1256,1225,1217,1191,-34
67000060006,1401,1377,1359,1324,-53
67000060007,992,964,947,925,-39
67000060008,482,462,446,456,-6
67000060009,432,419,403,400,-19
67000060010,394,410,392,389,-21
67000060011,2463,2403,2352,2294,-109
67000060012,767,750,730,726,-24
67000060013,1279,1256,1220,1187,-69
67000060014,1221,1203,1180,1175,-28
67000060015,1024,1019,993,967,-52
67000060016,2132,2098,2082,2042,-56
67000070001,806,,,,0
67000070002,628,,,,0
67000070003,3195,3158,3161,3134,-24
67000070004,2952,2959,2948,2951,-8
67000070005,1912,2510,2506,2499,-11
67000070006,2331,2306,2310,2254,-52
67000070007,1833,1827,1795,1752,-75
67000070008,1422,,,,0
67000070009,4282,4244,4219,4181,-63
67000070010,1276,1254,1238,1226,-28
67000070011,3467,3447,3462,3497,50
67000070012,747,,,,0
67000070013,854,,,,0
67000070014,2697,2688,2673,2613,-75
67000070015,1899,1869,1842,1849,-20
67000070016,1146,,,,0
67000070017,1568,2658,2626,2592,-66
67000070018,674,,,,0
67000070019,1130,2354,2344,2319,-35
67000070020,534,,,,0
67000070021,1432,1401,1371,1359,-42
67000070022,1261,1269,1280,1349,80
67000070023,697,,,,0
67000070024,706,1524,1488,1457,-67
67000070025,824,,,,0
67000070026,989,,,,0
67000070027,960,,,,0
67000070028,1053,1053,1047,1058,5
67000070029,1328,,,,0
67000080001,941,1784,1747,1691,-93
67000080002,3373,2304,2258,2240,-64
67000080003,1194,1834,1827,1799,-35
67000080004,1830,1817,1822,1824,7
67000080005,2864,2327,2330,2343,16
67000080006,2377,2393,2373,2366,-27
67000080007,977,,,,0
67000080008,807,,,,0
67000080009,1317,,,,0
67000080010,1256,,,,0
67000080011,2198,2144,2113,2076,-68
67000080012,1007,991,977,972,-19
67000080013,1481,1475,1452,1435,-40
67000080014,1242,,,,0
67000080015,1375,,,,0
67000090001,3438,3428,3420,3392,-36
67000090002,3183,3168,3117,3042,-126
67000090003,1602,1583,1552,1556,-27
67000090004,1184,,,,0
67000090005,1102,2241,2208,2220,-21
67000090006,3952,3962,3915,3840,-122
67000090007,2499,2474,2443,2438,-36
67000090008,1820,1800,1801,1781,-19
67000090009,1321,1339,1329,1335,-4
67000090010,670,657,642,644,-13
67000090011,836,830,808,795,-35
67000090012,668,666,651,625,-41
67000100001,2358,2322,2296,2285,-37
67000100002,3498,3504,3592,3588,84
67000100003,1071,,,,0
67000100004,299,,,,0
67000100005,447,431,427,429,-2
67000100006,2293,2288,2303,2269,-19
67000100007,4013,4009,4117,4135,126
67000100008,1359,1421,1430,1417,-4
67000100009,1480,,,,0
67000100010,693,,,,0
67000100011,562,,,,0
67000100012,2373,,,,0
67000100013,1002,985,986,972,-13
67000110001,1159,1135,1097,1085,-50
67000110002,728,709,696,667,-42
67000110003,1693,1654,1616,1614,-40
67000110004,1051,1017,1006,984,-33
67000110005,896,876,860,824,-52
67000110006,721,720,692,688,-32
67000110007,1083,1077,1073,1053,-24
67000110008,842,846,804,779,-67
67000110009,927,916,907,879,-37
67000110010,661,655,640,627,-28
67000120001,2039,2530,2547,2504,-26
67000120002,3353,3357,3335,3360,3
67000120003,6628,6535,6544,6465,-70
67000120004,10234,4862,4914,4962,100
67000120005,14056,7125,7130,7065,-60
67000120006,4788,4825,4830,4838,13
67000120007,2399,2415,2403,2390,-25
67000120008,1037,,,,0
67000120009,1380,,,,0
67000120010,776,,,,0
67000120011,413,,,,0
67000120012,1737,2518,2466,2443,-75
67000120013,811,,,,0
67000120014,1062,,,,0
67000120015,1006,,,,0
67000120016,1092,,,,0
67000120017,906,,,,0
67000120018,1176,,,,0
67000120019,1754,1807,1894,1937,130
67000120020,1666,2679,2643,2596,-83
67000120021,1067,,,,0
67000130001,4452,4398,4361,4345,-53
67000130002,2650,2620,2622,2706,86
67000130003,1435,1401,1357,1331,-70
67000130004,916,909,898,882,-27
67000130005,2239,2191,2299,2275,84
67000130006,2769,2775,2789,2809,34
67000130007,2286,2227,2204,2171,-56
67000130008,1392,1365,1333,1300,-65
67000130009,1217,1175,1150,1139,-36
67000130010,2434,2401,2369,2307,-94
67000130011,1106,1100,1067,1048,-52
67000130012,1557,1519,1505,1463,-56
67000130013,1625,1584,1547,1517,-67
67000140001,3876,3633,3610,3607,-26
67000140002,2754,2726,2696,2699,-27
67000140003,1792,1835,1860,1907,72
67000140004,1801,1846,1826,1842,-4
67000140005,1685,1673,1664,1632,-41
67000140006,1524,1677,1663,1643,-34
67000140007,883,845,831,834,-11
67000140008,1431,1456,1460,1517,61
67000140009,1333,1550,1504,1467,-83
67000140010,1169,1524,1514,1501,-23
67000140011,1250,922,922,918,-4
67000140012,5260,5003,5004,4955,-48
67000150001,586,1130,1095,1076,-54
67000150002,725,707,704,681,-26
67000150003,532,,,,0
67000150004,992,983,965,969,-14
67000150005,875,858,830,842,-16
67000150006,525,507,492,484,-23
67000150007,461,485,443,443,-42
67000150008,1863,1844,1813,1800,-44
67000150009,399,386,386,382,-4
67000150010,1084,1059,1029,1000,-59
67000150011,959,957,942,944,-13
67000150012,2091,3179,3129,3101,-78
67000150013,1131,,,,0
67000150014,864,,,,0
67000150015,1335,2209,2181,2176,-33
67000150016,700,,,,0
67000150017,777,758,746,736,-22
67000150018,729,1417,1378,1357,-60
67000150019,1293,2090,2075,2059,-31
67000150020,807,,,,0
67000150021,1129,1118,1099,1119,1
67000150022,1560,1515,1484,1463,-52
67000150023,1557,1530,1508,1510,-20
67000160001,1248,1274,1262,1277,3
67000160002,1608,,,,0
67000160003,1046,,,,0
67000160004,1862,,,,0
67000160005,963,,,,0
67000160006,1079,,,,0
67000160007,1161,,,,0
67000160008,732,,,,0
67000160009,650,,,,0
67000160010,679,,,,0
67000160011,647,,,,0
67000160012,481,,,,0
67000160013,943,913,906,883,-30
67000160014,704,691,670,664,-27
67000160015,1546,1513,1484,1452,-61
67000160016,1335,1315,1286,1281,-34
67000160017,2081,2104,2068,2023,-81
67000160018,1084,1052,1025,1010,-42
67000170001,1549,1525,1512,1495,-30
67000170002,518,507,492,492,-15
67000170003,858,,,,0
67000170004,827,,,,0
67000170005,946,936,915,892,-44
67000170006,1085,1052,1023,1018,-34
67000170007,1391,1378,1355,1311,-67
67000170008,711,,,,0
67000170009,816,803,779,752,-51
67000170010,705,,,,0
67000170011,819,836,822,803,-33
67000170012,410,,,,0
67000170013,553,954,943,925,-29
67000180001,2124,3618,3538,3480,-138
67000180002,4607,4565,4579,4633,68
67000180003,2123,3157,3129,3086,-71
67000180004,5175,5204,5205,5166,-38
67000180005,442,,,,0
67000180006,624,,,,0
67000180007,459,,,,0
67000180008,1086,,,,0
67000180009,3906,3874,3841,3785,-89
67000180010,2604,2580,2593,2542,-38
67000180011,1675,1682,1683,1731,49
67000180012,3897,3899,3879,3873,-26
67000180013,3240,3259,3246,3266,7
67000180014,2319,2340,2368,2447,107
67000180015,2495,2470,2447,2416,-54
67000180016,1701,1668,1661,1897,229
67000180017,498,492,475,459,-33
67000180018,2483,2494,2485,2443,-51
67000180019,1054,1047,1038,1042,-5
67000180020,1118,1107,1087,1051,-56
67000190001,1431,1449,1473,1461,12
67000190002,5103,5171,5146,5136,-35
67000190003,6673,6678,6718,6781,103
67000190004,3340,3325,3318,3336,11
67000190005,2258,2275,2257,2275,0
67000190006,799,,,,0
67000190007,557,,,,0
67000190008,1936,1939,1940,1945,6
67000190009,1417,1401,1407,1396,-5
67000190010,1985,2055,2334,2379,324
67000190011,1460,1470,1460,1454,-16
67000190012,2206,2179,2168,2239,60
67000190013,814,797,790,760,-37
67000190014,1232,1215,1209,1191,-24
67000190015,1978,1950,1906,1906,-44
67000190016,1017,,,,0
67000190017,1230,,,,0
67000190018,1767,1782,1850,1815,33
67000190019,1864,1780,1799,1804,24
67000190020,1176,1262,1260,1251,-11
67000190021,8143,5259,5433,5449,190
67000200001,3156,3479,3410,3348,-131
67000200002,7667,7415,7710,7933,518
67000200003,2947,3072,3206,3307,235
67000200004,795,807,803,803,-4
67000200005,1101,1105,1084,1077,-28
67000200006,2117,2143,2162,2205,62
67000200007,3928,3953,3957,4051,98
67000200008,5273,5241,5263,5318,77
67000200009,2075,2047,2064,2055,8
67000200010,4013,4081,4013,3984,-97
67000200011,3502,3555,3597,3579,24
67000210001,2424,2421,2378,2346,-75
67000210002,2417,2404,2367,2367,-37
67000210003,1686,1645,1624,1600,-45
67000210004,1598,2510,2485,2503,-7
67000210005,915,,,,0
67000210006,1832,1803,1780,1758,-45
67000210007,2138,2133,2123,2131,-2
67000210008,3405,3434,3439,3427,-7
67000210009,3098,3068,3123,3145,77
67000210010,847,,,,0
67000210011,1801,,,,0
67000210012,806,806,809,806,0
67000210013,2823,2815,2835,2820,5
67000210014,2962,2926,2934,2927,1
67000210015,1078,,,,0
67000210016,734,,,,0
67000220001,1954,1919,1918,1888,-31
67000220002,1753,1729,1691,1688,-41
67000220003,1112,1125,1096,1112,-13
67000220004,1046,1102,1066,1040,-62
67000220005,601,592,593,602,10
67000220006,400,405,397,368,-37
67000220007,448,445,438,430,-15
67000230001,858,1405,1376,1369,-36
67000230002,4728,4174,4172,4135,-39
67000230003,1395,1373,1360,1342,-31
67000230004,1683,1643,1619,1595,-48
67000230005,570,566,547,537,-29
67000230006,560,564,553,533,-31
67000230007,847,845,819,802,-43
67000230008,1708,1652,1609,1607,-45
67000230009,687,684,655,635,-49
67000230010,1115,1091,1059,1047,-44
67000240001,2110,2046,2018,1988,-58
67000240002,1316,1303,1264,1223,-80
67000240003,776,755,736,721,-34
67000240004,1127,1114,1085,1067,-47
67000240005,1074,1038,995,985,-53
67000240006,719,720,703,694,-26
67000240007,2595,2561,2518,2500,-61
67000250001,1558,1533,1518,1495,-38
67000250002,892,895,881,858,-37
67000250003,463,460,439,434,-26
67000250004,614,610,605,595,-15
67000250005,741,724,690,674,-50
67000250006,884,854,831,811,-43
67000250007,1333,1327,1295,1248,-79
67000250008,1193,1179,1186,1154,-25
67000250009,1109,1142,1138,1129,-13
67000260001,418,419,414,398,-21
67000260002,709,703,678,675,-28
67000260003,519,512,524,502,-10
67000260004,848,822,796,789,-33
67000260005,413,391,376,367,-24
67000260006,425,419,419,395,-24
67000260007,550,541,536,529,-12
67000260008,456,437,421,420,-17
67000260009,337,334,318,309,-25
67000260010,201,203,194,185,-18
67000270001,6353,6280,6286,6356,76
67000270002,3068,3228,3213,3243,15
67000270003,3120,3133,3081,3027,-106
67000270004,8810,8919,9090,9140,221
67000270005,10667,10604,10534,10567,-37
67000270006,3839,3868,3912,3945,77
67000270007,10823,10769,10871,10977,208
67000270008,6783,7008,7110,7059,51
67000270009,1645,,,,0
67000270010,942,,,,0
67000270011,3174,3203,3165,3121,-82
67000270012,5331,5342,5421,5490,148
67000270013,1478,1569,1621,1668,99
67000270014,1480,1422,1370,1424,2
67000270015,2431,2434,2387,2386,-48
67000270016,2458,2446,2454,2472,26
67000270017,1518,3046,3045,2997,-49
67000270018,1598,,,,0
67000280001,7230,7140,7085,6986,-154
67000280002,4379,4338,4358,4388,50
67000280003,2736,2714,2688,2688,-26
67000280004,3912,3900,3845,3847,-53
67000280005,3880,3861,3827,3807,-54
67000280006,3949,3917,3877,3824,-93
67000280007,2654,2677,2674,2718,41
67000280008,2118,2128,2158,2163,35
67000280009,3616,3687,3747,3793,106
67000280010,792,805,807,826,21
67000280011,2126,2150,2182,2229,79
67000280012,2154,2223,2113,2122,-101
67000280013,3020,3034,3024,3099,65
67000280014,3721,3786,3777,3818,32
67000280015,2341,2296,2259,2231,-65
67000280016,1976,1980,1956,1917,-63
67000280017,3350,3383,3427,3477,94
67000280018,5124,5134,5159,5177,43
67000280019,2953,2957,2943,2922,-35
67000280020,2655,2623,2615,2577,-46
67000280021,3738,3670,3614,3555,-115
67000290001,2496,2493,2520,2571,78
67000290002,2335,2335,2330,2304,-31
67000290003,3763,3716,3695,3631,-85
67000290004,2809,2827,2844,2863,36
67000290005,1191,1193,1190,1200,7
67000290006,812,804,785,756,-48
67000290007,3631,3656,3636,3626,-30
67000290008,3711,3641,3610,3579,-62
67000290009,2136,2143,2232,2200,57
67000290010,1622,,,,0
67000290011,2486,,,,0
67000290012,1744,1741,1685,1644,-97
67000290013,1411,1387,1374,1329,-58
67000290014,841,,,,0
67000290015,875,,,,0
67000290016,2055,2137,2136,2149,12
67000290017,515,544,529,511,-33
67000300001,1176,1158,1136,1090,-68
67000300002,691,678,666,642,-36
67000300003,149,148,148,148,0
67000300004,403,404,401,400,-4
67000300005,367,358,341,315,-43
67000300006,329,325,307,291,-34
67000300007,455,451,444,436,-15
67000300008,468,473,457,446,-27
67000310001,6679,6667,6677,6595,-72
67000310002,8341,8284,8338,8322,38
67000310003,10620,10600,10665,10523,-77
67000310004,13618,9134,9198,9118,-16
67000310005,6778,6740,6727,6728,-12
67000310006,3036,3041,2990,2973,-68
67000310007,3305,3316,3382,3392,76
67000310008,2133,2185,2157,2179,-6
67000310009,1670,1700,1712,1750,50
67000310010,10187,5762,5738,5735,-27
67000310011,2632,2667,2623,2607,-60
67000310012,4170,4077,4128,4110,33
67000310013,4294,4197,4156,4108,-89
67000310014,8692,8654,8597,8551,-103
67000310015,4572,4493,4467,4478,-15
67000310016,7038,6987,6878,6779,-208
67000310017,11118,5029,5006,5003,-26
67000310018,1801,2504,2505,2529,25
67000310019,2241,2245,2201,2169,-76
67000310020,9523,9763,9857,9792,29
67000310021,2010,2037,2139,2144,107
67000310022,1342,1340,1321,1378,38
67000310023,8025,7349,7411,7428,79
67000310024,2372,2382,2361,2291,-91
67000310025,3931,3876,3800,3773,-103
67000310026,8953,8989,8934,8814,-175
67000310027,12971,7401,7435,7448,47
67000310028,548,589,581,582,-7
67000310029,6957,6934,6852,6891,-43
67000310030,9441,9333,9314,9249,-84
67000310031,6553,6496,6478,6386,-110
67000310032,4008,4039,4049,4028,-11
67000310033,6804,7825,8856,9455,1630
67000310034,5831,5886,5855,5766,-120
67000310035,3643,3597,3556,3548,-49
67000310036,4516,4449,4428,4400,-49
67000310037,11004,10952,10853,10770,-182
67000310038,9387,9445,9393,9273,-172
67000310039,3161,3106,3181,3130,24
67000320001,2530,2496,2483,2450,-46
67000320002,3497,3477,3438,3378,-99
67000320003,7885,7850,7820,7741,-109
67000320004,3381,3383,3378,3333,-50
67000320005,5482,5440,5408,5307,-133
67000320006,5174,5177,5167,5160,-17
67000320007,3508,3459,3401,3363,-96
67000320008,6099,6042,5975,5929,-113
67000320009,2756,2750,2731,2722,-28
67000320010,3778,3681,3641,3564,-117
67000320011,1704,1646,1606,1559,-87
67000320012,5170,5057,4994,4938,-119
67000320013,6300,6376,6400,6410,34
67000320014,5554,5789,5943,5938,149
67000320015,1840,1815,1785,1784,-31
67000320016,1738,1695,1655,1611,-84
67000320017,5709,5758,5833,5903,145
67000320018,1801,1772,1788,1778,6
67000320019,5935,5993,6000,5940,-53
67000320020,5333,5277,5256,5239,-38
67000320021,2389,2347,2248,2202,-145
67000320022,5175,5177,5163,5050,-127
67000320023,1403,1334,1296,1268,-66
67000320024,5695,5688,5681,5694,6
67000320025,6037,6103,6252,6391,288
67000320026,3487,3505,3640,3781,276
67000320027,4519,4441,4380,4312,-129
67000320028,1941,1917,1877,1846,-71
67000320029,4826,4749,4711,4623,-126
67000320030,2836,2852,2818,2792,-60
67000320031,3599,3537,3500,3518,-19
67000320032,5640,5569,5552,5509,-60
67000320033,2574,2704,3057,3189,485
67000320034,2731,2728,2704,2667,-61
67000320035,3853,3826,3786,3757,-69
67000320036,2171,2112,2111,2093,-19
67000320037,2349,2287,2256,2245,-42
67000320038,3301,3265,3225,3155,-110
67000320039,4833,4819,4816,4671,-148
67000320040,5282,5228,5077,5019,-209
67000320041,7763,7675,7557,7436,-239
67000320042,4186,4068,4061,4082,14
67000320043,6166,6307,6418,6468,161
67000320044,3295,3324,3312,3341,17
67000320045,5616,5755,5809,5802,47
67000330001,1843,1828,1818,1797,-31
67000330002,563,,,,0
67000330003,832,1053,1570,1650,597
67000330004,896,1632,1725,1934,302
67000330005,2604,2562,2529,2521,-41
67000330006,2560,2523,2471,2439,-84
67000330007,3187,3124,3097,3028,-96
67000330008,3676,3618,3543,3518,-100
67000330009,3417,3410,3321,3258,-152
67000330010,2343,,,,0
67000330011,4856,4794,4760,4742,-52
67000330012,1993,,,,0
67000330013,4235,4190,4153,4066,-124
67000330014,2469,2441,2426,2410,-31
67000330015,2552,2526,2499,2477,-49
67000330016,1427,1397,1374,1339,-58
67000330017,3755,4121,4244,4339,218
67000330018,2448,2586,2957,3083,497
67000330019,2605,2584,2566,2558,-26
67000330020,3122,3061,2983,2974,-87
67000330021,2596,2539,2520,2461,-78
67000330022,5075,5078,5052,4993,-85
67000330023,3860,3830,3793,3756,-74
67000330024,3765,3783,3739,3737,-46
67000330025,2686,2629,2602,2548,-81
67000330026,3946,3871,3839,3771,-100
67000330027,3746,3732,3656,3590,-142
67000330028,5864,5714,5715,5669,-45
67000330029,3148,3094,3086,3073,-21
67000330030,6667,6612,6570,6504,-108
67000330031,1881,1854,1830,1777,-77
67000330032,5928,5911,5844,5771,-140
67000330033,4173,4134,4078,4016,-118
67000330034,5617,5577,5530,5496,-81
67000330035,5911,5815,5791,5681,-134
67000330036,2056,2030,1985,1967,-63
67000330037,2130,2111,2086,2060,-51
67000330038,2114,2032,1988,1932,-100
67000330039,2848,2776,2765,2740,-36
67000340001,2443,3879,3801,3760,-119
67000340002,1880,,,,0
67000340003,1221,,,,0
67000340004,2507,2506,2433,2372,-134
67000340005,2856,2804,2780,2682,-122
67000340006,2443,,,,0
67000340007,1981,2179,2156,2139,-40
67000340008,2044,2299,2287,2401,102
67000340009,1028,,,,0
67000340010,535,,,,0
67000340011,2521,,,,0
67000340012,1621,,,,0
67000340013,2375,,,,0
67000340014,2383,,,,0
67000340015,1649,,,,0
67000340016,1822,,,,0
67000340017,1581,,,,0
67000340018,5048,4924,4893,4816,-108
67000340019,2418,2067,2059,2027,-40
67000340020,8135,5839,5842,5714,-125
67000340021,1716,,,,0
67000340022,2778,,,,0
67000340023,3647,3598,3561,3502,-96
67000340024,5520,5506,5580,5573,67
67000340025,8270,4330,4463,4389,59
67000340026,6430,6375,6261,6161,-214
67000340027,1778,,,,0
67000340028,1622,,,,0
67000340029,1380,,,,0
67000340030,1839,,,,0
67000340031,2961,,,,0
67000340032,1641,1611,1576,1548,-63
67000340033,1990,2014,2006,2000,-14
67000340034,1649,,,,0
67000340035,1451,,,,0
67000340036,1309,,,,0
67000340037,1734,,,,0
67000340038,4574,4642,4774,4825,183
67000340039,3245,3497,3424,3382,-115
67000340040,15815,5663,5616,5639,-24
67000340041,4157,3585,3552,3518,-67
67000340042,4330,4310,4250,4175,-135
67000340043,4399,4411,4383,4311,-100
67000350001,3177,3394,3526,3583,189
67000350002,5668,5699,5777,5795,96
67000350003,5506,5495,5546,5629,134
67000350004,5783,5919,6093,6169,250
67000350005,5637,5638,5552,5507,-131
67000350006,3283,3223,3197,3198,-25
67000350007,4191,4246,4260,4231,-15
67000350008,5575,5674,5615,5581,-93
67000350009,7096,7224,7206,7147,-77
67000350010,7312,7352,7410,7397,45
67000350011,2577,2606,2533,2540,-66
67000350012,2111,2112,2097,2081,-31
67000350013,5489,5607,5569,5570,-37
67000350014,1379,1380,1361,1338,-42
67000350015,6611,6640,6708,6678,38
67000350016,3191,3293,3362,3393,100
67000350017,2252,2261,2239,2738,477
67000350018,8873,9247,9455,9624,377
67000350019,1840,1844,1862,1887,43
67000350020,5787,5644,5747,5831,187
67000350021,3781,3905,4166,4286,381
67000350022,3986,3998,4007,3961,-37
67000350023,2320,2362,2369,2485,123
67000350024,1109,1141,1103,1165,24
67000350025,2093,2062,2055,2056,-6
67000350026,2457,2553,2647,2775,222
67000350027,1820,1845,1852,1843,-2
67000350028,1729,1761,1812,1804,43
67000350029,1263,1269,1257,1251,-18
67000350030,3549,3620,3626,3696,76
67000350031,1655,1651,1671,1676,25
67000350032,1757,1735,1735,1725,-10
67000350033,1584,1547,1507,1508,-39
67000350034,1690,1686,1682,1687,1
67000350035,1046,1061,1074,1037,-24
67000350036,2238,2210,2194,2194,-16
67000350037,2519,2477,2478,2472,-5
67000350038,3336,3313,3276,3216,-97
67000350039,5554,5562,5504,5447,-115
67000350040,3904,3872,3835,3768,-104
67000350041,5119,5065,5044,5159,94
67000350042,4350,4242,4187,4274,32
67000350043,5359,5262,5242,5192,-70
67000350044,4805,4795,4745,4750,-45
67000350045,5519,5439,5401,5326,-113
67000350046,4688,4854,4957,4991,137
67000350047,4046,4041,4066,4048,7
67000350048,1785,1759,1724,1687,-72
67000350049,2720,2726,2755,3229,503
67000350050,6837,6869,6891,6767,-102
67000350051,4268,4258,4251,4231,-27
67000360001,1535,,,,0
67000360002,2294,2316,2285,2254,-62
67000360003,2475,,,,0
67000360004,473,464,464,454,-10
67000360005,6173,6292,6358,6385,93
67000360006,5054,5016,5015,4985,-31
67000360007,5663,5598,5543,5531,-67
67000360008,8524,8489,8528,8563,74
67000360009,6028,6023,6004,5926,-97
67000360010,8148,8502,9021,9135,633
67000360011,9352,9439,9488,9607,168
67000360012,3568,3595,3624,3681,86
67000360013,1726,,,,0
67000360014,1448,,,,0
67000360015,4035,3933,3842,3799,-134
67000370001,1745,,,,0
67000370002,1321,,,,0
67000370003,841,,,,0
67000370004,3001,,,,0
67000370005,1560,4634,4524,4616,-18
67000370006,2042,,,,0
67000370007,2033,4182,4267,4378,196
67000370008,1149,,,,0
67000370009,3683,3700,3935,3958,258
67000370010,1570,,,,0
67000370011,2358,3254,3258,3237,-17
67000370012,1546,,,,0
67000370013,1323,,,,0
67000370014,1471,,,,0
67000370015,1422,,,,0
67000370016,1532,3095,3221,3373,278
67000370017,1517,,,,0
67000370018,1514,,,,0
67000370019,2101,,,,0
67000370020,1094,,,,0
67000370021,1257,,,,0
67000370022,3843,3844,3829,3677,-167
67000370023,2444,,,,0
67000370024,1462,,,,0
67000370025,4220,4168,4128,4066,-102
67000370026,1342,,,,0
67000370027,1207,,,,0
67000370028,1678,,,,0
67000370029,1977,,,,0
67000370030,1199,,,,0
67000370031,3265,3002,3048,3021,19
67000370032,981,,,,0
67000370033,6312,6516,6706,6772,256
67000370034,5746,5722,5747,5725,3
67000370035,2004,,,,0
67000370036,1670,,,,0
67000370037,1140,,,,0
67000370038,1200,,,,0
64000010001,1515,1506,1482,1470,-36
64000010002,374,405,374,362,-43
64000010003,724,713,700,687,-26
64000010004,1455,1451,1437,1393,-58
64000010005,1196,1175,1253,1308,133
64000010006,2267,2249,2195,2171,-78
64000010007,929,925,918,894,-31
64000010008,683,691,677,648,-43
64000010009,1527,1518,1513,1551,33
64000010010,883,857,881,860,3
64000010011,1859,1812,1782,1747,-65
64000010012,798,841,790,787,-54
64000010013,1110,1092,1066,1053,-39
64000010014,1204,1222,1192,1182,-40
64000010015,1190,1170,1188,1160,-10
64000010016,947,939,944,915,-24
64000010017,2147,2161,2269,2224,63
64000010018,1370,1309,1271,1236,-73
64000010019,645,634,621,599,-35
64000010020,679,674,637,627,-47
64000010021,717,715,699,679,-36
64000020001,2169,2153,2124,2131,-22
64000020002,2201,2211,2185,2125,-86
64000020003,4621,4556,4562,4505,-51
64000020004,3853,3814,3762,3750,-64
64000020005,1465,1420,1414,1412,-8
64000020006,1247,1206,1222,1198,-8
64000020007,2720,2777,2765,2740,-37
64000020008,4238,4182,4203,4102,-80
64000020009,787,771,758,762,-9
64000020010,1397,1361,1353,1360,-1
64000020011,2290,2258,2263,2222,-36
64000020012,3976,3918,3883,3822,-96
64000020013,2951,2946,2930,2844,-102
64000020014,3511,3463,3428,3408,-55
64000020015,19816,20220,20572,20719,499
64000020016,27637,28874,29962,30927,2053
64000020017,20599,20726,20930,21010,284
64000020018,4454,4399,4319,4299,-100
64000020019,3612,3581,3543,3548,-33
64000020020,2840,2786,2779,2744,-42
64000020021,1340,1296,1263,1238,-58
64000020022,1285,1287,1281,1250,-37
64000020023,1988,1957,1981,2105,148
64000020024,1424,1401,1389,1352,-49
64000020025,1373,1369,1341,1344,-25
64000020026,1513,1496,1486,1487,-9
64000020027,1559,1544,1488,1437,-107
64000020028,1635,1614,1542,1515,-99
64000020029,691,664,650,634,-30
64000020030,933,935,932,888,-47
64000020031,1081,1077,1056,1046,-31
64000020032,1128,1103,1086,1074,-29
64000020033,872,858,843,828,-30
64000020034,1403,1358,1331,1290,-68
64000020035,1294,1266,1227,1200,-66
64000020036,1555,1520,1497,1487,-33
64000020037,1151,1141,1100,1091,-50
64000020038,650,625,605,594,-31
64000030001,2799,2746,2756,2813,67
64000030002,1158,1141,1115,1089,-52
64000030003,593,592,572,564,-28
64000030004,710,698,686,672,-26
64000030005,587,563,546,540,-23
64000030006,922,904,896,897,-7
64000030007,999,977,961,913,-64
64000030008,819,812,814,792,-20
64000030009,3743,3704,3689,3662,-42
64000030011,1817,1749,1715,1709,-40
64000030012,417,390,390,377,-13
64000030013,1055,991,983,968,-23
64000030015,1992,1991,1996,1963,-28
64000030016,2902,2861,2845,2829,-32
64000030017,2845,2917,2883,2846,-71
64000030019,823,790,799,749,-41
64000030021,1049,1049,1027,999,-50
64000030022,830,811,799,786,-25
64000030023,368,362,359,357,-5
64000030024,598,595,584,578,-17
64000030025,565,564,556,546,-18
64000030026,823,806,797,774,-32
64000030027,480,461,445,442,-19
64000030028,673,655,646,624,-31
64000030029,1005,965,956,940,-25
64000030030,1454,1439,1422,1380,-59
64000030031,1167,1139,1120,1077,-62
64000030032,6441,6422,6336,6255,-167
64000030034,3781,3692,3764,3760,68
64000030035,412,411,425,434,23
64000030036,3053,2973,2966,2987,14
64000030037,1656,1605,1605,1603,-2
64000030038,1781,1779,1739,1699,-80
64000030039,15549,15693,15944,16104,411
64000030040,30506,30418,30452,30277,-141
64000030041,5868,5826,5756,5667,-159
64000030042,16384,16535,16712,16739,204
64000030043,35045,35133,35307,35089,-44
64000030044,43403,43713,44365,44806,1093
64000040001,26250,26660,27287,27741,1081
64000040002,5069,5098,5132,5229,131
64000040003,7284,7366,7410,7708,342
64000040004,3673,3620,3765,3767,147
64000040005,3619,3845,3916,3920,75
64000040006,3536,3529,3527,3558,29
64000040007,4537,4587,4610,4675,88
64000040008,5445,5479,5516,5451,-28
64000040009,3485,3350,3263,3181,-169
64000040010,2590,2502,2440,2355,-147
64000040011,3666,3882,4008,4297,415
64000040012,1692,1622,1583,1532,-90
64000040013,4332,4176,4102,4101,-75
64000040014,17784,18041,18374,18496,455
64000040015,1069,979,893,807,-172
64000040016,3015,2973,2900,2722,-251
64000040017,3303,3280,3236,3184,-96
64000040018,3486,3433,3424,3368,-65
64000040019,3259,3253,3257,3274,21
64000040020,2519,2513,2458,2408,-105
64000040021,2403,2331,2369,2362,31
64000040022,6497,6464,6465,6373,-91
64000040023,1741,1712,1725,1680,-32
64000040024,5150,5170,5207,5266,96
64000040025,3092,3059,3027,3018,-41
64000040026,3875,3935,3956,4007,72
64000040027,2335,2295,2279,2274,-21
64000040028,3594,3562,3606,3620,58
64000040029,3942,3900,3861,3832,-68
64000040030,2502,2504,2511,2421,-83
64000040031,5501,5687,5821,5861,174
64000040032,4219,4218,4201,4174,-44
64000040033,10186,10123,10206,10164,41
64000040034,6160,6234,6178,6170,-64
64000040035,7792,8438,8892,9402,964
64000040036,1924,1916,1933,1999,83
64000040037,3225,3951,4661,5029,1078
64000051046,3318,3311,3274,,0
64000051047,2876,2824,2781,,0
64000051048,1518,1507,1456,,0
64000051049,1735,1702,1647,,0
64000051050,1716,1706,1660,,0
64000051051,1149,1091,1058,,0
64000051052,3029,2989,2986,,0
64000051053,2551,2500,2423,,0
64000051054,2171,2131,2089,,0
64000051055,1648,1613,1562,,0
64000051056,901,882,872,,0
64000051057,1221,1216,1200,,0
64000051058,1695,1665,1669,,0
64000051059,2316,2255,2183,,0
64000051060,3556,3545,3497,,0
64000051061,4367,4299,4259,,0
64000051062,4560,4638,4657,,0
64000051063,1907,1907,1946,,0
64000051064,2045,2041,2009,,0
64000051065,2058,2077,2091,,0
64000051066,815,775,771,,0
64000051067,1085,1108,1080,,0
64000051068,1566,1514,1487,,0
64000051069,1639,1606,1617,,0
64000051070,840,864,843,,0
64000051072,1327,1287,1240,,0
64000051073,4818,4736,4666,,0
64000051074,1215,1201,1185,,0
64000051075,1323,1305,1305,,0
64000051076,1928,1924,1924,,0
64000051077,964,957,923,,0
64000051078,1565,1547,1522,,0
64000051079,903,898,956,,0
64000051081,2816,2755,2710,,0
64000051082,1399,1360,1355,,0
64000051083,1460,1481,1461,,0
64000051084,1256,1232,1217,,0
64000051085,1248,1245,1240,,0
64000051086,1287,1296,1318,,0
64000051087,1188,1161,1162,,0
64000051088,2276,2242,2192,,0
64000052001,4547,4422,4394,,0
64000052002,9092,9039,9028,,0
64000052003,4715,4626,4643,,0
64000052004,4384,4430,4498,,0
64000052005,8298,8257,8226,,0
64000052006,3854,3802,3781,,0
64000052007,25383,25420,25498,,0
64000052008,9747,9731,9638,,0
64000052009,8167,8158,8123,,0
64000052010,2275,2260,2208,,0
64000052011,2120,2089,2054,,0
64000052012,6405,6364,6307,,0
64000052013,5805,5724,5629,,0
64000052014,5897,5958,5946,,0
64000052015,9209,9301,9361,,0
64000052016,4062,4050,4048,,0
64000052017,5748,5698,5647,,0
64000052018,4566,4521,4468,,0
64000052019,7551,7477,7436,,0
64000052020,3588,3526,3429,,0
64000052021,3711,3738,3747,,0
64000052022,9896,9744,9685,,0
64000052023,3714,3679,3676,,0
64000052024,3204,3236,3178,,0
64000052025,6544,6681,6830,,0
64000052026,5733,5647,5628,,0
64000052027,7939,7873,7905,,0
64000052028,4958,4910,4866,,0
64000052029,7139,6988,6948,,0
64000052030,9993,9986,10092,,0
64000052031,4375,4408,4351,,0
64000052032,3410,3381,3303,,0
64000052033,5930,5908,5894,,0
64000052034,2916,2923,2922,,0
64000052035,2102,2097,2082,,0
64000052036,3544,3497,3458,,0
64000052037,4023,3967,3961,,0
64000052038,14064,13942,14037,,0
64000052039,4652,4615,4564,,0
64000052040,2244,2241,2242,,0
64000052041,2605,2628,2647,,0
64000052042,3197,3142,3105,,0
64000052043,2086,2047,2026,,0
64000052044,5337,5266,5198,,0
64000052045,5259,5123,5069,,0
64000060001,1985,1962,1944,1941,-21
64000060002,1203,1159,1175,1134,-25
64000060003,3477,3455,3445,3443,-12
64000060004,1227,1200,1201,1163,-37
64000060005,1550,1517,1489,1428,-89
64000060006,756,737,717,711,-26
64000060007,1127,1083,1078,1082,-1
64000060008,2193,2177,2157,2099,-78
64000060009,1107,1080,1048,1023,-57
64000060010,841,833,820,811,-22
64000060011,1495,1480,1482,1460,-20
64000060012,932,881,842,823,-58
64000060013,2315,2366,2463,2494,128
64000060014,3191,3251,3380,3463,212
64000060015,2825,2827,2798,2775,-52
64000060016,1947,1965,1951,1931,-34
64000060017,4063,4104,4105,4021,-83
64000060018,1362,1397,1431,1450,53
64000060019,1275,1252,1233,1237,-15
64000060020,948,949,926,891,-58
64000060021,1112,1126,1122,1113,-13
64000060022,2172,2145,2135,2097,-48
64000060023,3184,3218,3223,3162,-56
64000060024,798,784,801,781,-3
64000060025,1182,1191,1156,1136,-55
64000060026,894,947,1009,1032,85
64000060027,1075,1056,1070,1044,-12
64000060028,1035,1030,1028,1026,-4
64000060029,892,894,889,868,-26
64000060030,777,782,777,773,-9
64000060031,849,846,818,799,-47
64000060032,1364,1338,1301,1279,-59
64000070001,770,753,738,724,-29
64000070002,1161,1142,1138,1119,-23
64000070003,1502,1485,1479,1458,-27
64000070004,962,942,906,902,-40
64000070005,1097,1088,1089,1071,-17
64000070006,4056,4089,4095,4059,-30
64000070007,800,785,775,735,-50
64000070008,1198,1229,1271,1295,66
64000070009,1813,1868,2000,1996,128
64000070010,840,828,857,822,-6
64000070011,1067,1059,1047,1104,45
64000070012,1091,1092,1080,1153,61
64000070013,1090,1058,1061,1055,-3
64000070014,1775,1721,1713,1651,-70
64000070015,1204,1201,1201,1166,-35
64000070016,1080,1124,1123,1104,-20
64000070017,1884,1858,1820,1782,-76
64000070018,1221,1207,1175,1167,-40
64000070019,1005,983,1003,1035,52
64000070020,1375,1319,1308,1270,-49
64000080001,803,794,796,795,1
64000080002,1635,1643,1640,1635,-8
64000080003,1378,1343,1331,1295,-48
64000080004,1829,1815,1806,1756,-59
64000080005,1621,1562,1555,1537,-25
64000080006,1636,1593,1579,1526,-67
64000080007,1669,1678,1739,1760,82
64000080008,635,627,596,575,-52
64000080009,2222,2207,2187,2151,-56
64000080010,4200,4163,4135,4122,-41
64000080011,1086,1057,1043,1013,-44
64000080012,1456,1422,1413,1408,-14
64000080013,1954,1948,1928,1906,-42
64000080014,1369,1360,1344,1313,-47
64000080015,1986,1961,1945,1910,-51
64000080016,1315,1265,1253,1243,-22
64000080017,3369,3308,3276,3257,-51
64000080018,2411,2393,2349,2313,-80
64000080019,3442,3469,3448,3437,-32
64000080020,2352,2321,2304,2300,-21
64000080021,2301,2318,2642,2821,503
64000080022,3704,3877,3917,4022,145
64000080023,2404,2577,2662,2803,226
64000080024,3092,3093,3106,3077,-16
64000080025,1952,1925,1948,1919,-6
64000080026,792,774,766,753,-21
64000080027,1496,1457,1431,1428,-29
64000080028,3159,3118,3054,2997,-121
64000080029,1762,1729,1700,1700,-29
64000080030,3124,3096,3056,3007,-89
64000080031,2399,2399,2432,2457,58
64000080032,3719,3696,3694,3671,-25
64000080033,3643,3668,3728,3710,42
64000080034,1939,1977,1943,1966,-11
64000080035,3353,3352,3300,3246,-106
64000080036,2661,2619,2644,2650,31
64000080037,2605,2605,2655,2828,223
64000080038,1804,1801,1797,1794,-7
64000080039,1616,1561,1558,1528,-33
64000080040,1975,1916,1855,1788,-128
64000080041,2321,2324,2355,2307,-17
64000080042,4212,4200,4154,4124,-76
64000080043,2052,1987,1996,1942,-45
64000080044,2148,2114,2077,2075,-39
64000080045,4477,4468,4434,4352,-116
64000080046,2206,2213,2120,2057,-156
64000080047,1713,1698,1656,1643,-55
64000080048,1659,1632,1605,1548,-84
64000080049,2906,2848,2811,2761,-87
64000080050,1367,1357,1338,1308,-49
64000080051,1228,1184,1156,1130,-54
64000080052,2137,2106,2103,2044,-62
64000080053,2328,2314,2286,2190,-124
64000080054,3045,2998,2932,2870,-128
64000080055,3069,3037,2975,2909,-128
64000080056,2980,2937,2903,2858,-79
64000080057,2024,2011,1969,1921,-90
64000080058,2440,2390,2345,2296,-94
64000080059,2309,2309,2321,2487,178
64000080060,3174,3107,3063,2983,-124
64000080061,5755,5720,5767,5649,-71
64000080062,4171,4142,4083,3931,-211
64000080063,4028,3978,3959,3870,-108
64000080064,4684,4609,4593,4588,-21
64000080065,2929,2859,2813,2759,-100
64000080066,2902,2874,2832,2755,-119
64000080067,4372,4312,4246,4159,-153
64000080068,2307,2257,2247,2246,-11
64000080069,2222,2176,2131,2101,-75
64000090001,10929,10882,10795,10724,-158
64000090002,2761,2734,2700,2661,-73
64000090003,5923,5823,5820,5771,-52
64000090004,2658,2635,2614,2586,-49
64000090005,1490,1482,1447,1417,-65
64000090006,2213,2144,2127,2127,-17
64000090007,3063,3111,3160,3165,54
64000090008,740,711,703,721,10
64000090009,1722,1670,1635,1617,-53
64000090010,1623,1596,1545,1521,-75
64000090011,2614,2545,2546,2502,-43
64000090012,1218,1196,1181,1178,-18
64000090013,780,775,732,733,-42
64000090014,831,782,790,750,-32
64000090015,1508,1492,1478,1465,-27
64000090016,1906,1874,1816,1771,-103
64000090017,2460,2490,2381,2309,-181
64000090018,2266,2259,2235,2193,-66
64000090019,4698,4651,4647,4541,-110
64000090020,1075,1040,1012,1001,-39
64000090021,3255,3249,3250,3205,-44
64000090022,856,829,904,906,77
64000090023,1193,1198,1200,1205,7
64000090024,5599,5540,5811,5825,285
64000090025,2416,2415,2405,2340,-75
64000090028,3858,3788,3750,3651,-137
64000090029,4759,4793,4774,4639,-154
64000090030,1464,1424,1389,1407,-17
64000090031,2533,2531,2524,2515,-16
64000090032,3182,3166,3147,3083,-83
64000090033,2277,2264,2273,2289,25
64000090034,3011,2980,2977,2945,-35
64000090035,3356,3334,3334,3342,8
64000090036,3497,3465,3432,3407,-58
64000090037,6211,6350,6424,6471,121
64000090038,3048,3070,3142,3264,194
64000090039,3112,3071,3014,2973,-98
64000090040,3216,3171,3138,3120,-51
64000090041,2519,2501,2465,2431,-70
64000090042,8525,8502,8564,8541,39
64000090043,2597,2547,2552,2708,161
64000090044,4808,4750,4752,4603,-147
64000090045,3841,3781,3833,3934,153
64000090046,2075,2021,1979,1908,-113
64000090047,5837,5811,5778,5751,-60
64000090048,3494,3481,3407,3387,-94
64000090049,6042,5945,5849,5704,-241
64000090050,2901,2850,2833,2794,-56
64000090051,2499,2423,2360,2281,-142
64000090052,4594,4475,4409,4316,-159
64000090053,4142,4167,4117,4039,-128
64000090054,3556,3566,3559,3539,-27
64000090055,2900,2919,2863,2839,-80
64000090056,2894,2862,2828,2786,-76
64000090057,2909,2850,2837,2805,-45
64000090058,2946,2865,2826,2807,-58
64000090059,2744,2715,2701,2669,-46
64000090060,5146,5138,5118,5032,-106
64000090061,3549,3641,3642,3614,-27
64000100001,1332,1320,1313,1303,-17
64000100002,1292,1265,1243,1213,-52
64000100003,1868,1863,1809,1758,-105
64000100004,2691,2663,2627,2578,-85
64000100005,3454,3415,3358,3344,-71
64000100006,1820,1833,1772,1736,-97
64000100007,1576,1567,1524,1560,-7
64000100008,3113,3102,3095,3046,-56
64000100009,2300,2264,2259,2232,-32
64000100010,3278,3241,3254,3202,-39
64000100011,2068,2066,2010,1976,-90
64000100012,1021,1010,988,979,-31
64000100013,2950,2897,2877,2858,-39
64000110001,2650,2727,2672,2643,-84
64000110002,3692,3694,3645,3643,-51
64000110003,3069,3055,3022,2960,-95
64000110004,2022,2011,1971,1924,-87
64000110005,3862,3731,3673,3625,-106
64000110006,3071,3080,3031,3010,-70
64000110007,2759,2759,3087,3182,423
64000110008,2646,2639,2608,2594,-45
64000110009,3025,3091,3117,3149,58
64000110010,6796,6830,6814,6717,-113
64000110011,2941,2897,2895,2854,-43
64000110012,4428,4342,4287,4201,-141
64000110013,3276,3239,3222,3186,-53
64000110014,4921,4923,4776,4731,-192
64000110015,5380,5304,5244,5183,-121
64000110016,3311,3273,3224,3139,-134
64000110017,4026,3998,3918,3885,-113
64000110018,3421,3427,3405,3384,-43
64000110019,2680,2627,2644,2596,-31
64000110020,4774,4770,4795,4779,9
64000110021,3893,3876,3873,3847,-29
64000110022,13604,13852,13895,13849,-3
64000110023,4542,4588,4643,4783,195
64000110024,3081,3050,3039,3062,12
64000110025,3675,3601,3565,3564,-37
64000110026,3206,3265,3249,3330,65
64000110027,6867,6958,7064,7120,162
64000110028,5091,5238,5339,5391,153
64000110029,4091,4172,4451,4654,482
64000110030,3061,3064,3052,3028,-36
64000110031,9340,9309,9294,9192,-117
64000110032,4087,4242,4322,4299,57
64000110033,3570,3557,3538,3507,-50
64000110034,3523,3532,3496,3482,-50
64000110035,2506,2494,2496,2477,-17
64000110036,3471,3445,3419,3417,-28
64000110037,2893,2876,2856,2834,-42
64000110038,4224,4206,4152,4135,-71
64000121001,471,485,461,,0
64000121002,693,705,696,,0
64000121003,1496,1485,1481,,0
64000121004,1067,1053,1045,,0
64000121005,1089,1069,1078,,0
64000121006,2700,2631,2589,,0
64000121007,1247,1257,1229,,0
64000121008,3939,3889,3864,,0
64000121009,9314,10113,11055,,0
64000121010,943,956,927,,0
64000121011,4086,4076,4094,,0
64000121012,5825,5726,5643,,0
64000121013,2818,2886,2837,,0
64000121014,7195,7157,7159,,0
64000121015,4718,4811,4769,,0
64000121018,6099,6099,6123,,0
64000121019,5330,5300,5277,,0
64000121020,4276,4269,4306,,0
64000121021,2837,2767,2828,,0
64000121022,3505,3427,3392,,0
64000121024,3965,3982,3981,,0
64000121030,6467,6361,6306,,0
64000121031,5925,5831,5796,,0
64000121035,7387,7449,7474,,0
64000121039,10100,10129,10126,,0
64000121041,2261,2205,2143,,0
64000121042,4237,4154,4105,,0
64000121044,6658,6642,6574,,0
64000121045,2374,2338,2292,,0
64000121046,6330,6211,6148,,0
64000121047,4102,4003,3955,,0
64000121048,7087,7154,7223,,0
64000121050,2947,2999,3039,,0
64000121051,1181,1192,1197,,0
64000121053,4933,4855,4811,,0
64000121056,10375,10307,10321,,0
64000121058,3014,2988,2928,,0
64000121059,4763,4690,4701,,0
64000121060,11365,11543,11522,,0
64000121061,2420,2440,2447,,0
64000121062,3089,3084,3060,,0
64000122016,5460,5422,5424,,0
64000122017,7897,7808,7805,,0
64000122025,3563,3529,3482,,0
64000122026,5604,5577,5480,,0
64000122027,7133,7125,7110,,0
64000122028,3765,3735,3669,,0
64000122029,7112,7092,7090,,0
64000122032,4108,4041,4091,,0
64000122033,6469,6552,6518,,0
64000122034,4263,4231,4144,,0
64000122036,4854,4796,4769,,0
64000122037,3760,3712,3648,,0
64000122038,2849,2796,2770,,0
64000122040,15881,16325,16751,,0
64000122043,3667,3649,3660,,0
64000122049,5157,5391,5548,,0
64000122054,2878,2843,2866,,0
64000122055,9910,10022,10108,,0
64000122057,5282,5299,5284,,0
64000122063,2950,2939,2911,,0
64000122064,2720,2733,2742,,0
64000122065,4545,4508,4482,,0
64000122066,2702,2752,2740,,0
64000122067,5230,5183,5169,,0
64000122068,5036,5026,4983,,0
64000122069,2839,2799,2766,,0
64000122070,5045,5022,4979,,0
64000122071,4980,5004,5001,,0
64000122072,5481,5470,5446,,0
64000122073,3304,3260,3233,,0
64000122074,2928,2906,2862,,0
64000122075,6205,6199,6155,,0
64000122076,3181,3157,3125,,0
64000122077,3366,3320,3261,,0
64000122078,8368,8578,8808,,0
64000130001,3455,3459,3414,3435,-24
64000130002,3965,3742,3663,3662,-80
64000130003,4688,4718,4747,4828,110
64000130004,3231,3222,3195,3171,-51
64000130005,3570,3510,3489,3498,-12
64000130006,2924,2888,2894,2871,-17
64000130007,5296,5282,5331,5349,67
64000130008,2086,2094,2060,2040,-54
64000130009,3987,4003,3974,3931,-72
64000130010,1945,1966,1950,1944,-22
64000130011,1851,1855,1823,1794,-61
64000130012,2366,2366,2372,2371,5
64000130013,4698,4874,4875,4895,21
64000130014,1456,1454,1428,1444,-10
64000130015,2155,2154,2227,2228,74
64000130016,2083,2081,2065,2022,-59
64000130017,2141,2119,2062,2034,-85
64000130018,1008,992,990,970,-22
64000130019,858,841,825,815,-26
64000130020,3603,3626,3606,3574,-52
64000130021,2814,2772,2751,2770,-2
64000130022,4098,4093,4099,4043,-50
64000130023,3053,3087,3128,3170,83
64000130024,2659,2672,2636,2619,-53
64000140001,1645,1631,1614,1571,-60
64000140002,6779,6827,6840,6813,-14
64000140003,7925,7886,7889,7896,10
64000140004,2789,2817,2784,2779,-38
64000140005,5173,5260,5251,5331,71
64000140006,5043,5009,5073,5138,129
64000140007,4440,4471,4542,4501,30
64000140008,2581,2566,2594,2598,32
64000140009,12727,12688,12610,12640,-48
64000140010,8881,8955,9020,8965,10
64000140011,2047,2036,2002,2004,-32
64000140012,1905,1899,1873,1882,-17
64000140013,2897,2852,2838,2839,-13
64000140014,3409,3400,3340,3319,-81
64000140015,1785,1758,1757,1759,1
64000140016,7060,7045,7111,7195,150
64000140017,8651,8634,8614,8561,-73
64000140018,598,597,581,570,-27
64000140019,8080,7985,7893,7821,-164
64000140020,2400,2464,2481,2502,38
64000140021,1751,1768,1723,1740,-28
64000140022,2139,2116,2128,2123,7
64000140023,4056,4080,4086,4146,66
64000140024,205,203,200,180,-23
64000140025,7431,7474,7415,7392,-82
64000150001,3096,3077,3088,3080,3
64000150002,5936,5959,5983,5987,28
64000150003,4757,4741,4728,4657,-84
64000150004,2683,2671,2650,2640,-31
64000150005,2650,2603,2570,2542,-61
64000150006,4156,4033,3996,3982,-51
64000150007,1305,1257,1236,1203,-54
64000150008,1144,1139,1129,1112,-27
64000150009,1132,1093,1085,1087,-6
64000150010,1703,1680,1684,1647,-33
64000150011,1844,1816,1784,1746,-70
64000150012,1525,1523,1517,1503,-20
64000150013,1933,2018,1976,1968,-50
64000150014,2893,2879,2883,2900,21
64000150015,1158,1142,1144,1125,-17
64000150016,1875,1829,1825,1789,-40
64000150017,2200,2156,2113,2061,-95
64000150018,767,774,751,735,-39
64000160001,1064,1081,1056,1035,-46
64000160002,3508,3585,3553,3615,30
64000160003,5738,5705,5681,5605,-100
64000160004,1962,1928,1913,1878,-50
64000160005,3064,3027,3020,3039,12
64000160006,6197,6256,6235,6263,7
64000160007,5657,5721,5712,5697,-24
64000160008,3731,3676,3623,3587,-89
64000160009,3656,3625,3617,3605,-20
64000170001,4664,4735,4811,4997,262
64000170002,8809,9115,9256,9509,394
64000170003,2988,2942,2953,2967,25
64000170004,4540,4570,4563,4525,-45
64000170005,936,932,917,945,13
64000170006,6361,6413,6435,6447,34
64000170007,10624,10595,10816,10888,293
64000170008,2520,2503,2489,2461,-42
64000170009,18457,18968,19466,20454,1486
64000170010,2020,2174,2589,2910,736
64000170011,2940,2966,2953,2934,-32
64000170012,1828,1837,1803,1779,-58
64000170013,5170,5506,5791,6016,510
64000170014,4505,4552,4563,4626,74
64000170015,7059,7373,7672,7913,540
64000170016,2473,2513,2518,2522,9
64000180001,11355,11429,11749,11757,328
64000180002,5270,5263,5343,5477,214
64000180003,10914,11070,11173,11159,89
64000180004,4074,4013,4041,4005,-8
64000180005,7339,7347,7389,7313,-34
64000180006,789,788,779,765,-23
64000180007,4550,4559,4486,4462,-97
64000190001,1374,1336,1283,1261,-75
64000190002,5158,5176,5158,5178,2
64000190003,4071,4056,4043,3996,-60
64000190004,1195,1180,1156,1140,-40
64000190005,4863,4875,4864,4885,10
64000190006,1494,1492,1472,1519,27
64000190007,3406,3427,3482,3435,8
64000190008,354,355,348,353,-2
64000190009,3451,3341,3315,3297,-44
64000190010,1615,1617,1612,1610,-7
64000190011,4228,4231,4234,4205,-26
64000190012,6463,6430,6451,6376,-54
64000190013,1899,1876,1861,1823,-53
64000190014,885,870,887,869,-1
64000190015,1003,996,1001,992,-4
64000190016,3892,3844,3808,3772,-72
64000190017,4499,4551,4578,4505,-46
64000190018,4894,4865,4852,4814,-51
64000190019,8579,8674,8736,8777,103
64000190020,6915,6973,7198,7347,374
64000190021,2216,2224,2211,2211,-13
64000190022,2156,2171,2178,2240,69
64000190023,2179,2189,2203,2179,-10
64000190024,1198,1199,1208,1177,-22
64000190025,2080,2043,2024,1992,-51
64000190026,3995,3958,3883,3865,-93
64000190027,2080,2052,2063,2037,-15
64000190028,1828,1830,1828,1808,-22
64000190029,1165,1165,1180,1188,23
64000190030,2483,2476,2426,2389,-87
64000190031,799,777,776,775,-2
64000190032,2773,2710,2690,2720,10
64000190033,2139,2144,2118,2106,-38
64000200001,2524,2509,2504,2481,-28
64000200002,1240,1249,1232,1228,-21
64000200003,2725,2688,2653,2636,-52
64000200004,2882,2860,2986,3029,169
64000200005,1383,1356,1346,1345,-11
64000200006,2746,2745,2693,2668,-77
64000200007,1647,1594,1571,1559,-35
64000200008,3883,3914,3877,3879,-35
64000200009,1812,1789,1773,1760,-29
64000200010,2592,2839,3647,4469,1630
64000200011,2268,2239,2226,2247,8
64000200012,2764,2742,2682,2689,-53
64000200013,1479,1499,1499,1428,-71
64000200014,759,743,726,730,-13
64000200015,4298,4299,4235,4163,-136
64000200016,1663,1670,1698,1740,70
64000200017,914,915,906,904,-11
64000210001,1241,1280,1245,1229,-51
64000210002,2426,2425,2404,2398,-27
64000210003,3895,3895,3833,3806,-89
64000210004,3052,3038,3032,3037,-1
64000210005,2739,2727,2746,2743,16
64000210006,542,536,526,521,-15
64000210007,2758,2711,2716,2680,-31
64000210008,4399,4395,4497,4466,71
64000210009,3943,3941,3862,3819,-122
64000210010,2121,2091,2101,2083,-8
64000210011,2806,2781,2724,2711,-70
64000220001,387,399,388,377,-22
64000220002,1163,1128,1110,1079,-49
64000220003,398,397,383,381,-16
64000220004,385,403,394,374,-29
64000220005,647,651,647,624,-27
64000220006,1052,1044,1034,1021,-23
64000220007,887,860,870,855,-5
64000220008,424,410,394,373,-37
64000220009,575,544,534,541,-3
64000220010,1327,1323,1289,1294,-29
64000230001,1490,1479,1477,1469,-10
64000230002,2376,2366,2340,2302,-64
64000230003,1429,1426,1416,1403,-23
64000230004,2510,2518,2493,2466,-52
64000230005,863,870,882,866,-4
64000230006,5870,5819,5867,5836,17
64000230007,3150,3108,3093,3091,-17
64000230008,2761,2700,2686,2690,-10
64000230009,1757,1741,1720,1740,-1
64000230010,1913,1909,1874,1848,-61
64000230011,1204,1170,1161,1175,5
64000230012,3521,3552,3480,3445,-107
64000240001,3939,3896,3929,3911,15
64000240002,1426,1412,1395,1368,-44
64000240003,1447,1452,1441,1420,-32
64000240004,1310,1324,1330,1328,4
64000240005,1518,1487,1441,1420,-67
64000240006,2710,2664,2598,2552,-112
64000240007,2437,2470,2467,2451,-19
64000240008,3944,3934,3886,3847,-87
64000240009,3103,3070,3074,3043,-27
64000240010,2069,2067,2069,2044,-23
64000240011,4418,4389,4398,4394,5
64000240012,2794,2778,2764,2719,-59
64000240013,3904,3871,3742,3699,-172
64000240014,3014,2992,2955,2934,-58
64000240015,1005,992,986,981,-11
64000240016,2346,2360,2321,2331,-29
64000240017,1902,1945,1938,1939,-6
64000240018,992,972,963,946,-26
64000240019,3456,3394,3382,3296,-98
64000240020,5027,5069,5106,5103,34
64000250001,1268,1244,1238,1216,-28
64000250002,1152,1139,1109,1112,-27
64000250003,908,887,884,874,-13
64000250004,2609,2618,2636,2628,10
64000250005,3132,3149,3132,3142,-7
64000250006,4214,4250,4274,4292,42
64000250007,1116,1111,1100,1132,21
64000250008,4292,4329,4334,4396,67
64000250009,2050,2052,2026,2005,-47
64000250010,1310,1332,1322,1357,25
64000250011,2520,2515,2494,2506,-9
64000250012,1305,1292,1272,1290,-2
64000250013,771,765,768,772,7
64000250014,3156,3111,3095,3160,49
64000260001,1111,1092,1081,1066,-26
64000260002,1036,1028,1005,982,-46
64000260003,1941,1945,1928,1943,-2
64000260004,4465,4466,4482,4494,28
64000260005,2092,2092,2085,2083,-9
64000260006,1292,1256,1235,1219,-37
64000260007,3308,3340,3366,3394,54
64000260008,1070,1030,1039,1019,-11
64000260009,1236,1219,1211,1192,-27
64000260010,1302,1288,1271,1253,-35
64000260011,2357,2369,2387,2366,-3
64000260012,1291,1267,1256,1246,-21
64000260013,1131,1108,1097,1088,-20
64000260014,1316,1325,1291,1283,-42
64000260015,5269,5264,5272,5332,68
64000270001,1769,1786,1774,1784,-2
64000270002,2096,2072,2039,2038,-34
64000270003,2668,2632,2586,2561,-71
64000270004,433,432,444,446,14
64000270005,2956,2960,2934,2935,-25
64000270006,4058,4027,4009,3941,-86
64000280001,1507,1488,1493,1500,12
64000280002,2174,2175,2161,2158,-17
64000280003,614,619,621,617,-2
64000280004,860,842,823,824,-18
64000280005,2087,2078,2077,2025,-53
64000280006,1860,1835,1793,1777,-58
64000280007,2006,1980,1940,1910,-70
64000280008,2402,2375,2371,2311,-64
64000280009,1077,1072,1072,1077,5
64000280010,1007,1004,954,929,-75
64000280011,1386,1377,1351,1338,-39
64000280012,2403,2407,2393,2406,-1
64000290001,2514,2479,2434,2420,-59
64000290002,2391,2392,2371,2345,-47
64000290003,2667,2639,2656,2631,-8
64000290004,1751,1765,1770,1787,22
64000290005,1363,1370,1380,1389,19
64000290006,2105,2070,2045,2025,-45
64000290007,2395,2328,2322,2277,-51
64000290008,3262,3277,3266,3238,-39
64000290009,2723,2747,2705,2682,-65
64000290010,1169,1160,1148,1140,-20
64000290011,4312,4268,4314,4354,86
64000290012,2550,2516,2487,2443,-73
64000290013,930,947,912,898,-49
64000290014,2668,2658,2622,2567,-91
64000290015,3316,3324,3318,3321,-3
64000300001,2632,2609,2587,2624,15
64000300002,2768,2736,2731,2714,-22
64000300003,1941,1887,1858,1818,-69
64000300004,2084,2047,2056,2030,-17
64000300005,1689,1687,1660,1613,-74
64000300006,1563,1538,1517,1495,-43
64000300007,1113,1138,1123,1104,-34
64000300008,888,874,862,844,-30
64000300009,2424,2411,2373,2338,-73
64000300010,180,183,184,178,-5
64000300011,2259,2239,2216,2181,-58
64000300012,1154,1144,1115,1099,-45
64000300013,1850,1839,1853,1821,-18
64000300014,2415,2392,2396,2349,-43
64000300015,4097,4052,3999,3902,-150
64000300016,2505,2565,2554,2555,-10
64000300017,824,804,780,749,-55
64000300018,1436,1421,1424,1378,-43
64000300019,947,921,903,890,-31
64000300020,1440,1435,1409,1394,-41
64000300021,731,730,713,688,-42
64000310001,2922,2881,2846,2803,-78
64000310002,2758,2767,2703,2707,-60
64000310003,2888,2915,2890,2866,-49
64000310004,2346,2331,2295,2250,-81
64000310005,1719,1686,1659,1636,-50
64000310006,2398,2382,2366,2318,-64
64000310007,2898,2843,2794,2758,-85
64000310008,1635,1586,1536,1526,-60
64000310009,1538,1510,1476,1451,-59
64000310010,1321,1295,1274,1264,-31
64000310011,2354,2356,2360,2349,-7
64000310012,1399,1372,1341,1316,-56
64000310013,1765,1757,1780,1763,6
64000310014,2513,2497,2522,2514,17
64000310015,2052,2023,1983,1936,-87
64000310016,2129,2101,2065,2041,-60
64000310017,1549,1537,1495,1491,-46
64000310018,2111,2083,2043,2029,-54
64000310019,1678,1667,1646,1593,-74
64000320001,815,832,794,774,-58
64000320002,753,725,720,718,-7
64000320003,708,761,708,690,-71
64000320004,1147,1132,1123,1071,-61
64000320005,1599,1579,1548,1528,-51
64000320006,1120,1098,1068,1055,-43
64000320007,1187,1200,1192,1174,-26
64000320008,954,939,920,905,-34
64000320009,1642,1614,1571,1566,-48
64000320010,1043,1036,1030,987,-49
64000320011,1706,1680,1624,1600,-80
64000320012,342,343,335,323,-20
64000330001,513,517,496,483,-34
64000330002,1010,990,987,978,-12
64000330003,754,729,722,732,3
64000330004,1813,1786,1780,1752,-34
64000330005,740,723,705,697,-26
64000330006,658,665,648,640,-25
64000330007,619,616,605,595,-21
64000340001,706,703,694,677,-26
64000340002,748,751,730,717,-34
64000340003,1444,1395,1368,1350,-45
64000340004,1691,1644,1627,1596,-48
64000340005,1798,1754,1737,1718,-36
64000340006,1814,1772,1774,1763,-9
64000340007,1416,1408,1378,1348,-60
64000340008,2421,2368,2373,2372,4
64000350001,1088,1072,1049,1032,-40
64000350002,708,702,687,663,-39
64000350003,1108,1098,1084,1061,-37
64000350004,456,459,450,439,-20
64000350005,455,441,432,428,-13
64000350006,568,561,547,543,-18
64000350007,1119,1110,1092,1087,-23
64000350008,1375,1378,1370,1333,-45
64000350009,1934,1928,1878,1862,-66
64000350010,626,622,610,589,-33
64000350011,894,884,866,859,-25
64000350012,453,457,445,445,-12
64000350013,553,541,536,530,-11
64000350014,756,750,733,717,-33
64000350015,652,645,639,644,-1
64000350016,664,665,670,675,10
64000350017,366,367,359,343,-24
64000350018,765,757,748,726,-31
64000360001,886,910,884,873,-37
64000360002,425,447,431,421,-26
64000360003,613,637,622,621,-16
64000370001,970,991,980,988,-3
64000370002,505,520,520,505,-15
64000370003,762,766,743,728,-38
64000370004,802,814,806,795,-19
64000370005,281,279,272,268,-11
64000370006,346,346,339,343,-3
64000370007,272,285,302,291,6
64000370008,308,310,299,305,-5
64000380001,1707,1712,1713,1715,3
64000380002,795,805,807,810,5
64000380003,623,631,626,622,-9
10002010001,3065,3037,2998,2921,-116
10002010002,2065,2024,2015,2023,-1
10002010008,2439,2464,2471,2465,1
10002010009,1455,1497,1538,1560,63
10002010010,2141,2153,2164,2322,169
10002010011,2552,2582,2612,2674,92
10002010012,1518,1535,1546,1550,15
10002010013,2311,2278,2301,2325,47
10002010014,2772,2753,2775,2796,43
10002010015,4089,4175,4160,4155,-20
10002010016,1755,1766,1792,1784,18
10002010017,2113,2086,2092,2052,-34
10002010018,1768,1783,1741,1705,-78
10002010019,1121,1093,1081,1075,-18
10002010021,1770,1839,1838,1848,9
10002010022,1468,1491,1510,1512,21
10002010023,1341,1325,1367,1300,-25
10002010024,3034,3045,3069,3117,72
10002010025,2422,2430,2493,2558,128
10002010026,2611,2637,2617,2596,-41
10002010027,3692,3670,3614,3662,-8
10002010028,1324,1325,1298,1300,-25
10002010031,1051,1054,1009,987,-67
10002010032,1995,2013,2031,2042,29
10002010034,1698,1670,1647,1621,-49
10002010035,3784,3730,3709,3703,-27
10002010036,2837,2811,2767,2682,-129
10002010037,1989,1944,1950,1921,-23
10002010038,5346,5260,5313,5246,-14
10002010039,3842,3803,3758,3762,-41
10002010040,3160,3087,3061,3042,-45
10002010041,3856,3875,3876,3877,2
10002010042,3950,3952,3898,3895,-57
10002010043,3163,3142,3128,3117,-25
10002010044,2583,2546,2562,2528,-18
10002010045,870,865,847,842,-23
10002010046,3534,3522,3462,3417,-105
10002010047,3434,3470,3452,3413,-57
10002020004,1828,1828,1851,1854,26
10002020005,4463,4433,4404,4394,-39
10002020006,3211,3240,3230,3198,-42
10002020007,3656,3631,3634,3650,19
10002020008,2847,2806,2838,2800,-6
10002020009,1605,1647,1667,1637,-10
10002020010,1871,1886,1854,1870,-16
10002020011,1390,1369,1353,1361,-8
10002020016,4750,4720,4726,4693,-27
10002020017,3401,3441,3404,3391,-50
10002020018,3582,3600,3532,3558,-42
10002020019,4534,4547,4477,4429,-118
10002020020,3541,3539,3572,3508,-31
10002020021,1507,1464,1420,1375,-89
10002020022,3717,3717,3720,3781,64
10002020023,3708,3704,3640,3591,-113
10002020024,4486,4529,4543,4484,-45
10002020025,4391,4394,4375,4310,-84
10002020026,5573,5642,5526,5524,-118
10002020027,3814,3821,3757,3752,-69
10002020028,1646,1641,1596,1587,-54
10002020029,1627,1639,1615,1580,-59
10002020030,1171,1195,1164,1157,-38
10002030001,3866,3877,3873,3806,-71
10002030002,1157,1154,1139,1169,15
10002030003,4463,4481,4481,4485,4
10002030004,1037,1026,989,971,-55
10002030005,1576,1532,1467,1454,-78
10002030007,3548,3564,3647,3688,124
10002030008,1482,1479,1506,1656,177
10002030009,2688,2669,2643,2613,-56
10002030010,2808,2734,2680,2666,-68
10002030011,1173,1158,1120,1076,-82
10002030012,501,494,488,479,-15
10002030013,585,591,565,556,-35
10002030014,596,615,614,610,-5
10002030015,501,514,507,495,-19
10002030016,665,660,642,616,-44
10002030017,532,518,499,497,-21
10002030018,1061,1045,1020,1010,-35
10002030019,1072,1041,1016,988,-53
10002030020,1271,1256,1208,1180,-76
10002030021,1673,1627,1599,1550,-77
10002030022,1206,1175,1141,1123,-52
10002030023,1422,1380,1334,1292,-88
10002030024,391,386,376,350,-36
10002030025,834,820,826,813,-7
10002030026,655,647,618,608,-39
10002030027,3293,3239,3157,3113,-126
10002040001,318,314,316,321,7
10002040002,793,775,758,756,-19
10002040003,1025,993,1009,992,-1
10002040004,387,374,394,390,16
10002040005,1500,1509,1501,1497,-12
10002040006,1025,1007,986,974,-33
10002040007,783,787,787,762,-25
10002040008,1859,1863,1832,1836,-27
10002040009,1590,1561,1543,1539,-22
10002040010,816,815,802,811,-4
10002040011,588,587,579,570,-17
10002040012,651,645,628,599,-46
10002040013,764,752,746,737,-15
10002040014,2539,2498,2449,2423,-75
10002040015,2441,2398,2399,2386,-12
10002040016,2437,2443,2510,2550,107
10002040017,1112,1101,1098,1077,-24
10002040018,1974,1960,1998,1999,39
10002040019,798,802,786,777,-25
10002040020,1564,1575,1534,1511,-64
10002040021,1080,1064,1045,1046,-18
10002040022,1222,1199,1189,1174,-25
10002040023,1319,1314,1297,1279,-35
10002040024,813,797,799,813,16
10002050001,1873,1872,1857,1852,-20
10002050002,2244,2239,2213,2209,-30
10002050003,4576,4597,4626,4600,3
10002050004,3002,2997,2971,2943,-54
10002050005,750,745,716,724,-21
10002050006,1664,1664,1645,1615,-49
10002050007,1413,1384,1357,1337,-47
10002050008,1650,1627,1648,1665,38
10002050009,2465,2447,2385,2353,-94
10002050010,2843,2751,2764,2770,19
10002050011,1364,1364,1335,1301,-63
10002050012,953,962,930,927,-35
10002050013,1167,1195,1178,1184,-11
10002050014,1528,1499,1504,1529,30
10002050015,2919,2901,2942,2933,32
10002050016,3795,3820,3812,3824,4
10002050017,1078,1085,1068,1034,-51
10002050018,493,470,466,474,4
10002060001,2879,2929,3019,3054,125
10002060002,2067,2056,2129,2127,71
10002060003,1062,1074,1056,1037,-37
10002060004,1095,1088,1095,1080,-8
10002060005,1828,1821,1800,1785,-36
10002060006,1734,1695,1683,1659,-36
10002060007,899,885,881,859,-26
10002060008,2665,2708,2726,2746,38
10002060009,1761,1788,1779,1782,-6
10002060010,1415,1406,1397,1399,-7
10002060011,2510,2513,2497,2510,-3
10002060012,1164,1160,1163,1148,-12
10002060013,1977,1984,1978,1939,-45
10002060014,1194,1195,1221,1241,46
10002070001,6558,6513,6619,6646,133
10002070002,2482,2434,2412,2387,-47
10002070003,1895,1883,1879,1931,48
10002070004,1715,1728,1740,1730,2
10002070005,2133,2144,2230,2263,119
10002070006,1375,1346,1370,1386,40
10002070007,1660,1739,1698,1670,-69
10002070008,702,702,689,660,-42
10002070009,2109,2088,2069,2072,-16
10002070010,1526,1543,1529,1511,-32
10002070011,2650,2649,2628,2603,-46
10002070012,2876,2795,2767,2756,-39
10002070013,1032,1016,996,997,-19
10002070014,994,982,995,1016,34
10002070015,1144,1138,1118,1104,-34
10002070016,1607,1581,1545,1526,-55
10002080001,1328,1342,1346,1385,43
10002080002,1906,1917,1926,1910,-7
10002080003,1359,1374,1371,1332,-42
10002080004,1040,1031,1022,1041,10
10002080005,1040,1033,1011,990,-43
10002080006,1667,1665,1668,1683,18
10002080007,3858,3891,3959,3951,60
10002080008,3913,3853,3842,3804,-49
10002080009,845,797,792,792,-5
10002080010,870,874,864,849,-25
10002080011,1730,1725,1712,1696,-29
10002080012,1002,1008,987,969,-39
10002080013,1628,1644,1680,1683,39
10002080014,556,542,540,519,-23
10002080015,5726,5637,5565,5586,-51
10002080016,3431,3376,3451,3441,65
10002080017,5321,5264,5254,5267,3
10002080018,4483,4460,4537,4548,88
10002080019,2722,2712,2812,2835,123
10002080020,1243,1222,1229,1192,-30
10002080021,2816,2774,2795,2777,3
10002080022,1912,1871,1872,1877,6
10002080023,1977,1960,1968,2021,61
10002080024,916,908,900,876,-32
10002090001,2291,2281,2312,2331,50
10002090002,2029,1967,2018,2110,143
10002090003,2863,2846,2911,2978,132
10002090004,1747,1742,1764,1735,-7
10002090005,1448,1435,1472,1501,66
10002090006,2693,2744,2771,2855,111
10002090007,2047,1970,2022,2025,55
10002090008,4161,4185,4263,4289,104
10002090009,4132,4181,4208,4283,102
10002090010,3770,3739,3754,3734,-5
10002090011,1747,1752,1766,1825,73
10002090012,1626,1609,1603,1582,-27
10002090013,2252,2251,2223,2212,-39
10002090014,3628,3647,3683,3720,73
10002090015,3239,3194,3189,3117,-77
10002100001,227,220,212,197,-23
10002100002,611,582,557,557,-25
10002100003,838,841,835,839,-2
10002100004,660,650,654,625,-25
10002100005,506,491,492,490,-1
10002100006,1387,1393,1376,1352,-41
10002100007,1323,1295,1301,1292,-3
10002100008,1030,1015,1004,998,-17
10002100009,1425,1421,1430,1441,20
10002100010,4825,4830,4852,4866,36
10002100011,989,991,965,973,-18
10002100012,687,685,671,659,-26
10002100013,548,561,581,582,21
10002100014,826,803,798,792,-11
10002100015,1308,1375,1386,1403,28
10002100016,857,852,829,828,-24
10002100017,1784,1760,1750,1737,-23
10002100018,1636,1594,1585,1584,-10
10002110001,1124,1126,1113,1131,5
10002110002,768,794,774,784,-10
10002110003,843,850,865,859,9
10002110004,308,296,292,283,-13
10002110005,412,420,399,407,-13
10002110006,484,496,483,471,-25
10002110007,63,56,58,50,-6
10002110008,995,1032,1014,1005,-27
10002110009,863,915,888,893,-22
10002110010,242,257,257,254,-3
10002120001,1474,1475,1442,1412,-63
10002120002,1240,1265,1267,1272,7
10002120003,558,569,567,586,17
10002120004,564,576,577,572,-4
10002120005,544,540,540,513,-27
10002120006,598,626,606,631,5
10002120007,922,964,971,968,4
10004010001,8411,8855,9317,9665,810
10004010002,14585,15272,15799,16340,1068
10004010003,15135,16192,17433,18172,1980
10004010004,9079,9689,10849,11728,2039
10004010005,3221,3367,3721,4017,650
10004010006,3678,3650,3605,3553,-97
10004010007,8324,8517,9406,9815,1298
10004010008,11635,11559,11414,11377,-182
10004010009,7269,7139,7162,7077,-62
10004010010,7214,7283,7335,7386,103
10004010011,8486,8458,8388,8555,97
10004010012,5407,5340,5284,5248,-92
10004010013,2268,2301,2363,2358,57
10004010014,2799,2823,2830,2848,25
10004010015,2549,2494,2482,2514,20
10004010016,1420,1428,1423,1390,-38
10004010017,1862,1852,1882,1877,25
10004010018,2255,2262,2253,2211,-51
10004010019,2083,2055,2057,2080,25
10004010020,1827,1882,1942,1936,54
10004010021,9813,9938,10253,10391,453
10004010022,6563,7089,7154,7312,223
10004010023,1250,1216,1202,1199,-17
10004010024,4986,4948,4987,5010,62
10004010025,7508,7504,7710,7732,228
10004010026,3983,3935,3945,3969,34
10004010027,7396,8008,8631,9528,1520
10004010028,3785,5053,6313,7719,2666
10004010029,4720,4668,4643,4748,80
10004010030,4437,4415,4453,4457,42
10004010031,8007,8144,8280,8570,426
10004040001,573,563,546,557,-6
10004040002,2314,2279,2247,2219,-60
10004040003,831,805,789,772,-33
10004040004,4374,4365,4312,4288,-77
10004040005,1223,1177,1141,1133,-44
10004040006,862,862,866,852,-10
10004040007,1278,1253,1238,1210,-43
10004040008,4366,4355,4373,4404,49
10004040009,1505,1531,1462,1435,-96
10004040010,667,628,609,601,-27
10004040011,659,641,611,592,-49
10004040012,1105,1082,1050,1054,-28
10004040013,549,532,513,495,-37
10004040014,903,901,878,874,-27
10004040015,2144,2083,2050,2006,-77
10004040016,939,927,917,905,-22
10004040017,612,598,590,580,-18
10004040018,974,970,943,927,-43
10004040019,959,955,933,915,-40
10004040020,1007,979,953,949,-30
10004040021,1052,1051,1034,1007,-44
10004030001,1328,1305,1271,1258,-47
10004030002,997,981,975,966,-15
10004030003,4812,4800,4769,4834,34
10004030004,2353,2346,2350,2315,-31
10004030005,3915,3848,3858,3761,-87
10004030006,2103,2070,2026,1978,-92
10004030007,2888,2955,3002,3588,633
10004030008,1163,1127,1100,1104,-23
10004030009,691,683,664,644,-39
10004030010,1256,1228,1196,1175,-53
10004030011,2159,2125,2137,2119,-6
10004030012,2749,2767,2772,2758,-9
10004030013,1162,1159,1125,1107,-52
10004030014,738,743,723,729,-14
10004030015,1364,1331,1317,1281,-50
10004030016,1696,1628,1591,1540,-88
10004030017,493,491,452,431,-60
10004030018,847,824,817,806,-18
10004030019,701,693,653,633,-60
10004020001,377,362,356,336,-26
10004020002,453,445,437,428,-17
10004020003,427,432,419,422,-10
10004020004,2572,2579,2562,2577,-2
10004020005,3860,3824,3767,3702,-122
10004020006,11253,11148,11181,11118,-30
10004020007,5719,5597,5609,5567,-30
10004020008,855,817,781,742,-75
10004020009,3709,3666,3682,3662,-4
10004020010,1587,1561,1559,1556,-5
10004020011,1677,1647,1623,1585,-62
10004020012,4806,4756,4643,4531,-225
10004020013,4103,4018,4000,3979,-39
10004020014,9749,9603,9378,9287,-316
10004020015,7802,7818,7818,7851,33
10004020016,5098,5077,5145,5142,65
10004020017,2136,2144,2175,2162,18
10004020018,692,677,666,672,-5
10004020019,13118,13376,14544,14804,1428
10004020020,2084,2042,1995,1972,-70
10004020021,2244,2235,2271,2496,261
10004020022,1280,1255,1240,1199,-56
10004020023,8676,8715,8707,8772,57
10004020024,1914,1869,1859,1841,-28
10004020025,727,717,710,697,-20
10004050001,1528,1466,1444,1425,-41
10004050002,1042,1036,1047,1038,2
10004050003,4875,4787,4731,4713,-74
10004050004,6447,6401,6406,6415,14
10004050005,3584,3685,3890,4089,404
10004050006,5762,5796,5817,5892,96
10004050007,3412,3373,3318,3289,-84
10004050008,3919,3896,3890,3833,-63
10004050009,1360,1336,1285,1241,-95
10004050010,3349,3312,3306,3269,-43
10004050011,2857,2830,2818,2887,57
10004050012,1887,1870,1851,1822,-48
10004050013,2659,2650,2632,2631,-19
10004050014,5974,5970,5905,5873,-97
10004050015,3741,3740,3685,3733,-7
10004050016,7362,7342,7402,7484,142
10004050017,4176,4271,4331,4667,396
10004050018,3557,3753,4007,4389,636
10004050019,5068,5145,5144,5242,97
10004050020,4885,5009,4999,5039,30
10004080001,3971,3919,3842,3743,-176
10004080002,961,965,954,939,-26
10004080003,208,212,201,189,-23
10004080004,239,233,228,225,-8
10004080005,386,378,371,361,-17
10004080006,1064,1057,1029,1022,-35
10004080007,496,495,477,455,-40
10004080008,1069,1069,1057,1048,-21
10004080009,1864,1810,1819,1768,-42
10004080010,1855,1855,1896,1904,49
10004080011,951,949,915,893,-56
10004060001,1196,1209,1175,1184,-25
10004060002,2049,2057,2059,2018,-39
10004060003,2084,2065,2057,2042,-23
10004060004,3174,3184,3182,3191,7
10004060005,2020,2067,2091,2142,75
10004060006,1000,988,989,972,-16
10004060007,3853,3833,3785,3764,-69
10004060008,6351,6398,6330,6391,-7
10004060009,2460,2400,2397,2364,-36
10004060010,3168,3210,3235,3281,71
10004060011,6022,5960,5917,5864,-96
10004060012,1758,1757,1754,1706,-51
10004060013,1265,1240,1207,1204,-36
10004060014,4628,4549,4575,4568,19
10004060015,5201,5306,5480,5591,285
10004060016,7363,7573,7844,8014,441
10004060017,3244,3184,3215,3215,31
10004070001,581,604,565,550,-54
10004070002,484,466,456,444,-22
10004070003,1089,1081,1046,1037,-44
10004070004,483,490,475,463,-27
10004070005,3124,3075,3037,2977,-98
10004070006,1857,1854,1853,1822,-32
10004070007,742,721,713,713,-8
10004070008,910,907,909,904,-3
10004070009,2816,2812,2771,2731,-81
10004070010,1797,1838,1852,1820,-18
10004070011,4900,4918,5019,5180,262
10004070012,1278,1259,1238,1231,-28
10004100001,2950,3028,3083,3090,62
10004100002,2085,2100,2168,2203,103
10004100003,1192,1161,1119,1114,-47
10004100004,1355,1365,1357,1326,-39
10004100005,929,936,903,905,-31
10004100006,825,838,822,801,-37
10004100007,639,620,596,592,-28
10004100008,872,913,910,936,23
10004100009,628,645,620,605,-40
10004100010,3075,3041,3048,3047,6
10004090001,1343,1333,1302,1290,-43
10004090002,1417,1375,1326,1304,-71
10004090003,3051,3041,3047,3022,-19
10004090004,977,981,958,930,-51
10004090005,444,443,430,419,-24
10004090006,848,853,837,814,-39
10004090007,618,629,603,591,-38
10004090008,390,366,369,361,-5
10004090009,302,314,306,304,-10
10004110001,957,973,941,952,-21
10004110002,751,757,753,738,-19
10004110003,658,655,639,611,-44
10004110004,1569,1585,1570,1539,-46
10004110005,678,672,662,658,-14
10004110006,925,945,914,905,-40
10004120001,702,715,699,677,-38
10004120002,989,971,965,957,-14
10004120003,1592,1636,1602,1533,-103
10004120004,802,781,772,795,14
10004120005,1499,1541,1523,1537,-4
10004120006,1719,1799,1818,1840,41
10004120007,2240,2252,2259,2307,55
10004130001,1584,1657,1597,1562,-95
10004130002,831,859,848,837,-22
10004130003,426,459,439,422,-37
10004130004,1718,1799,1709,1666,-133
10005010001,1364,1364,1394,1400,36
10005010002,5094,4998,4993,4887,-111
10005010003,1214,1170,1187,1199,29
10005010004,2691,2659,2654,2585,-74
10005010005,4485,4434,4383,4344,-90
10005010006,4420,4298,4199,4171,-127
10005010007,3985,3881,3850,3818,-63
10005010008,981,976,941,925,-51
10005010009,3697,3739,3754,3736,-3
10005010010,1075,1038,1037,1012,-26
10005010011,616,585,580,574,-11
10005010012,988,968,945,921,-47
10005010013,4526,4483,4437,4395,-88
10005010014,1631,1608,1573,1548,-60
10005010015,1941,1922,1884,1834,-88
10005010016,6212,6189,6249,6226,37
10005010017,3731,3659,3644,3628,-31
10005010018,4206,4124,4062,3983,-141
10005010019,5002,4946,4930,4955,9
10005010020,1396,1370,1341,1336,-34
10005010021,4584,4606,4736,4976,370
10005010022,6264,6314,6505,6588,274
10005010023,2893,2882,2887,2884,2
10005010024,1993,1973,1952,1970,-3
10005010025,4121,4077,4037,4073,-4
10005010026,3441,3375,3287,3227,-148
10005010027,2313,2273,2211,2153,-120
10005010028,4301,4305,4324,4323,18
10005050001,2662,2585,2539,2526,-59
10005050002,2040,2031,1995,1972,-59
10005050003,3603,3557,3500,3425,-132
10005050004,4493,4385,4388,4391,6
10005050005,5216,5203,5148,5227,24
10005050006,3141,3102,3093,3053,-49
10005050007,1096,1157,1171,1160,3
10005050008,4061,4009,3970,3915,-94
10005050009,4121,3983,3890,3882,-101
10005050010,1844,1864,1823,1866,2
10005050011,1083,1089,1084,1113,24
10005050012,1254,1228,1259,1249,21
10005050013,2382,2346,2398,2426,80
10005050014,3854,4391,4891,5292,901
10005050015,4982,4976,5123,5291,315
10005050016,4826,4861,4902,4944,83
10005050017,7450,4177,4381,4482,305
10005050018,4782,4816,4832,4870,54
10005050019,1589,1567,1513,1498,-69
10005050020,2393,2428,2498,2584,156
10005050021,3092,3036,2992,2956,-80
10005050022,1591,1574,1542,1495,-79
10005050023,3100,3039,2976,2899,-140
10005050024,1064,1048,1019,1013,-35
10005050025,2585,2554,2548,2566,12
10005050026,2435,2421,2539,2674,253
10005050027,2806,2811,2838,2844,33
10005050028,4658,4555,4429,4413,-142
10005050029,4725,4662,4592,4514,-148
10005050030,2591,2488,2427,2390,-98
10005050031,3288,3236,3211,3186,-50
10005050032,4340,4414,4446,4521,107
10005020001,2665,2629,2570,2553,-76
10005020002,1879,1827,1758,1706,-121
10005020003,1031,998,1000,993,-5
10005020004,1841,1817,1839,1860,43
10005020005,1475,1445,1428,1406,-39
10005020006,2380,2338,2326,2283,-55
10005020007,1270,1218,1216,1207,-11
10005020008,2681,2634,2624,2555,-79
10005020009,4756,4703,4729,4752,49
10005020010,2572,2525,2518,2499,-26
10005020011,1061,1043,1044,1042,-1
10005020012,757,718,711,712,-6
10005020013,1563,1537,1523,1522,-15
10005020014,1588,1577,1573,1531,-46
10005020015,2170,2075,2069,2046,-29
10005020016,1451,1437,1427,1422,-15
10005020017,620,618,582,584,-34
10005020018,920,918,894,889,-29
10005020019,2747,2745,2696,2757,12
10005020020,1887,1869,1869,1864,-5
10005020021,1881,1853,1823,1793,-60
10005020022,2085,2033,2035,2028,-5
10005020023,796,791,760,751,-40
10005020024,1715,1685,1662,1653,-32
10005020025,2185,2178,2172,2154,-24
10005030001,1289,1266,1256,1222,-44
10005030002,2283,2226,2224,2202,-24
10005030003,2239,2200,2172,2157,-43
10005030004,1806,1772,1760,1735,-37
10005030005,813,789,781,757,-32
10005030006,3191,3148,3093,3068,-80
10005030007,795,756,743,731,-25
10005030008,1049,1023,991,974,-49
10005030009,877,867,854,839,-28
10005030010,750,735,712,682,-53
10005030011,1400,1355,1324,1310,-45
10005030012,1549,1500,1495,1534,34
10005030013,1674,1657,1642,1625,-32
10005030014,2185,2131,2120,2074,-57
10005030015,512,504,495,466,-38
10005030016,1067,1050,1015,1000,-50
10005030017,452,432,424,422,-10
10005030018,934,929,897,881,-48
10005030019,2640,2600,2547,2526,-74
10005030020,1356,1319,1304,1278,-41
10005030021,891,858,840,821,-37
10005030022,1653,1630,1592,1605,-25
10005030023,832,820,793,773,-47
10005030024,2454,2425,2397,2379,-46
10005040001,2351,2276,2259,2247,-29
10005040002,4450,4443,4514,4557,114
10005040003,3403,3375,3330,3295,-80
10005040004,5650,5849,5908,6004,155
10005040005,6695,6656,6657,6613,-43
10005040006,4328,4328,4347,4323,-5
10005040007,4627,4665,4677,4686,21
10005040008,3879,3907,3873,3884,-23
10005040009,2585,2565,2552,2493,-72
10005040010,5983,6067,6153,6277,210
10005040011,1324,1313,1294,1315,2
10005040012,3463,3420,3384,3359,-61
10005040013,1713,1731,1714,1734,3
10005040014,2445,2380,2347,2308,-72
10005040015,1243,1266,1330,1439,173
10005040016,4844,5015,5027,5088,73
10005040017,2601,2625,2684,2724,99
10005040018,1411,1360,1353,1331,-29
10005040019,4577,4895,4987,5256,361
10005040020,2529,2469,2412,2374,-95
10005040021,4339,4332,4295,4337,5
10005040022,1217,1188,1177,1147,-41
10005040023,4341,4340,4504,4518,178
10005040024,2808,2836,2923,2955,119
10005040025,2781,2829,2864,2926,97
10005060001,1768,1773,1714,1701,-72
10005060002,968,947,917,908,-39
10005060003,1625,1592,1561,1500,-92
10005060004,5249,5229,5165,5154,-75
10005060005,2743,2678,2623,2570,-108
10005060006,1454,1438,1424,1435,-3
10005060007,1179,1179,1211,1210,31
10005060008,3382,3310,3261,3198,-112
10005060009,1643,1610,1558,1515,-95
10005060010,831,806,786,778,-28
10005060011,1724,1720,1675,1657,-63
10005060012,1775,1748,1730,1685,-63
10005060013,1450,1443,1426,1422,-21
10005060014,1126,1119,1103,1087,-32
10005060015,1177,1171,1158,1130,-41
10005060016,1070,1029,1019,1013,-16
10005060017,834,809,786,760,-49
10005060018,1201,1180,1165,1162,-18
10005060019,705,686,678,672,-14
10005060020,1450,1423,1421,1430,7
10005060021,831,826,815,811,-15
10005060022,1197,1180,1154,1127,-53
10005060023,1368,1361,1325,1296,-65
10005070001,844,830,791,778,-52
10005070002,1758,1723,1719,1697,-26
10005070003,2422,2363,2329,2281,-82
10005070004,1156,1116,1091,1065,-51
10005070005,883,856,856,854,-2
10005070006,1125,1138,1108,1094,-44
10005070007,2284,2224,2170,2131,-93
10005070008,1288,1245,1228,1214,-31
10005070009,2523,2468,2403,2336,-132
10005070010,829,802,794,776,-26
10005070011,2022,1967,1959,1970,3
10005080001,1896,1878,1843,1794,-84
10005080002,695,675,655,635,-40
10005080003,2098,2069,2034,1999,-70
10005080004,1620,1589,1558,1536,-53
10005080005,637,612,600,572,-40
10005080006,1444,1408,1390,1337,-71
10005080007,743,733,707,685,-48
10005080008,1809,1777,1745,1702,-75
10005080009,880,860,845,835,-25
10005080010,563,554,537,525,-29
10005080011,1174,1160,1143,1130,-30
10005080012,1179,1167,1137,1134,-33
10005090001,1942,1914,1866,1838,-76
10005090002,2953,2937,2894,2830,-107
10005090003,4228,4188,4167,4187,-1
10005090004,1113,1073,1055,1038,-35
10005090005,2718,2675,2617,2627,-48
10005090006,2832,2798,2743,2728,-70
10005090007,1813,1766,1739,1689,-77
10005090008,1236,1229,1194,1152,-77
10005090009,2451,2401,2382,2382,-19
10005090010,319,323,303,295,-28
10005090011,392,383,374,364,-19
10005090012,2630,2594,2554,2552,-42
10005090013,1707,1681,1668,1660,-21
10005090014,1877,1852,1848,1809,-43
10005090015,1733,1692,1684,1644,-48
10005090016,1501,1483,1477,1442,-41
10005090017,1701,1662,1603,1579,-83
10005090018,257,238,230,229,-9
10005090019,370,372,356,352,-20
10005100001,1215,1195,1149,1111,-84
10005100002,5311,5228,5196,5137,-91
10005100003,1976,1929,1900,1859,-70
10005100004,1510,1488,1468,1441,-47
10005100005,1412,1402,1356,1318,-84
10005100006,1261,1228,1208,1186,-42
10005100007,3707,3645,3605,3562,-83
10005100008,669,664,647,622,-42
10005100009,469,477,455,456,-21
10005100010,608,615,604,587,-28
10005110001,1308,1298,1283,1250,-48
10005110002,730,728,701,678,-50
10005110003,1635,1623,1587,1555,-68
10005110004,936,916,901,874,-42
10005110005,950,937,904,872,-65
10005110006,1245,1217,1193,1162,-55
10005110007,1193,1179,1150,1122,-57
10005110008,1018,1010,1004,985,-25
10005110009,1161,1134,1090,1075,-59
10005120001,2911,2894,2857,2837,-57
10005120002,2151,2099,2053,2024,-75
10005120003,857,831,812,784,-47
10005120004,2009,1975,1928,1877,-98
10005120005,1006,1010,992,954,-56
10005120006,413,413,411,406,-7
10005120007,1138,1105,1080,1042,-63
10005120008,355,340,322,316,-24
10005130001,4969,4865,4764,4642,-223
10005130002,2237,2155,2133,2091,-64
10005130003,1620,1581,1557,1534,-47
10005130004,4082,4034,3997,3943,-91
10005130005,1709,1677,1654,1624,-53
10005130006,459,468,455,455,-13
10005130007,1454,1424,1410,1376,-48
10005140001,675,670,664,655,-15
10005140002,624,615,602,594,-21
10005140003,945,920,896,876,-44
10005140004,717,715,703,692,-23
10005140005,559,558,544,523,-35
10005140006,502,492,478,475,-17
10005140007,1040,1020,986,963,-57
10005140008,1325,1289,1266,1227,-62
10005140009,767,754,738,724,-30
10005150001,2411,2384,2370,2310,-74
10005150002,536,522,513,475,-47
10005150003,1211,1174,1140,1109,-65
10005150004,4124,4041,3938,3837,-204
10005150005,593,583,569,540,-43
10005150006,583,573,554,543,-30
10005150007,1508,1446,1423,1401,-45
10005150008,882,894,901,914,20
10005150009,1104,1084,1065,1048,-36
10005160001,2626,2574,2570,2527,-47
10005160002,741,711,693,680,-31
10005160003,994,985,967,930,-55
10005160004,270,255,256,247,-8
10005160005,620,605,593,569,-36
10005160006,620,604,587,568,-36
10005160007,463,458,455,443,-15
10005160008,422,421,411,400,-21
10005170001,359,355,352,353,-2
10005170002,643,617,587,584,-33
10005170003,1021,996,986,957,-39
10005170004,639,628,617,601,-27
10005170005,658,643,624,609,-34
10005170006,351,358,353,341,-17
10005170007,746,734,712,713,-21
10005180001,364,394,383,376,-18
10005180002,1296,1312,1288,1238,-74
10005180003,950,980,959,942,-38
10005180004,543,555,539,531,-24
10005180005,638,652,621,602,-50
10005180006,597,651,630,620,-31
10005180007,780,787,778,774,-13
10005180008,715,708,690,699,-9
10007010001,1656,1597,1576,1539,-58
10007010002,6622,6657,6641,6577,-80
10007010003,2140,2094,2043,2063,-31
10007010004,1035,1010,989,983,-27
10007010005,1809,1791,1742,1704,-87
10007010006,2158,2148,2108,2079,-69
10007010007,5069,4969,4940,4846,-123
10007010008,6647,6662,6735,6715,53
10007010009,2179,2167,2152,2167,0
10007010010,2284,2281,2285,2290,9
10007010011,983,970,933,924,-46
10007010012,1737,1746,1767,1702,-44
10007010013,1047,1034,1011,1005,-29
10007010014,828,828,786,750,-78
10007010015,846,833,826,819,-14
10007010016,1022,1017,1009,989,-28
10007010017,874,848,836,830,-18
10007010018,975,964,951,947,-17
10007010019,1329,1279,1235,1218,-61
10007010020,4068,4066,4043,3994,-72
10007010021,4569,4579,4521,4500,-79
10007010022,1502,1459,1451,1429,-30
10007010023,3883,3869,3837,3834,-35
10007010024,5239,5188,5144,5143,-45
10007010025,1205,1163,1123,1088,-75
10007010026,4189,4255,4220,4171,-84
10007010027,2621,2616,2568,2557,-59
10007010028,2183,2165,2231,2264,99
10007010029,3605,3581,3590,3579,-2
10007010030,3949,3966,3922,3878,-88
10007010031,4972,4969,4876,4881,-88
10007010032,3013,2952,2883,2839,-113
10007010033,2980,2892,2935,2933,41
10007010034,1841,1829,1794,1761,-68
10007010035,1150,1126,1129,1111,-15
10007010036,1416,1393,1383,1337,-56
10007010037,2147,2103,2083,2047,-56
10007010038,1754,1726,1701,1688,-38
10007010039,9144,9074,9010,9038,-36
10007010040,1769,1772,1726,1730,-42
10007010041,6155,6189,6265,6351,162
10007010042,8847,8963,9297,9426,463
10007010043,3401,3369,3319,3224,-145
10007010044,3486,3429,3395,3354,-75
10007010045,1747,1720,1689,1703,-17
10007010046,2959,2988,3006,3001,13
10007010047,11202,11230,11462,11655,425
10007010048,2799,2801,2741,2682,-119
10007010049,1189,1166,1165,1148,-18
10007010050,3940,3949,3952,3886,-63
10007010051,2039,1966,1956,1970,4
10007010052,2314,2308,2294,2299,-9
10007010053,3870,3922,3983,3956,34
10007010054,3393,3392,3429,3452,60
10007010055,8044,7982,7921,7830,-152
10007010056,2964,2911,2836,2803,-108
10007010057,1385,1384,1380,1385,1
10007010058,2933,2902,2912,2845,-57
10007010059,1489,1519,1496,1505,-14
10007010060,1123,1118,1120,1148,30
10007010061,3677,3708,3725,3721,13
10007010062,10423,10512,10655,10631,119
10007010063,2894,2863,2877,2855,-8
10007010064,5282,5235,5143,5081,-154
10007010065,3394,3369,3370,3370,1
10007010066,1336,1319,1286,1266,-53
10007010067,1483,1433,1390,1383,-50
10007010068,966,956,954,959,3
10007010069,1084,1073,1062,1046,-27
10007010070,1271,1291,1244,1252,-39
10007010071,5174,5152,5169,5127,-25
10007010072,6327,6304,6278,6218,-86
10007010073,6584,6668,6753,6836,168
10007100001,1244,1239,1239,1209,-30
10007100002,3240,3250,3214,3170,-80
10007100003,4039,3996,3960,3896,-100
10007100004,3204,3138,3154,3099,-39
10007100005,909,889,869,845,-44
10007100006,3492,3435,3408,3374,-61
10007100007,999,977,946,912,-65
10007100008,737,712,705,705,-7
10007100009,2175,2146,2139,2102,-44
10007100010,6711,6708,6683,6608,-100
10007100011,3165,3182,3238,3144,-38
10007100012,5223,5228,5184,5157,-71
10007100013,6270,6475,6700,6890,415
10007100014,5656,5822,5809,5879,57
10007100015,2161,2190,2195,2130,-60
10007100016,2823,2780,2785,2663,-117
10007100017,3220,3329,3408,3398,69
10007100018,7910,7873,7849,7735,-138
10007100019,3536,3560,3592,3610,50
10007100020,2290,2262,2233,2241,-21
10007100021,2616,2794,2873,2917,123
10007100022,3784,3808,3857,3907,99
10007100023,2917,2864,2853,2806,-58
10007100024,4281,4353,4358,4418,65
10007100025,2813,2835,2753,2698,-137
10007100026,3160,3156,3167,3156,0
10007100027,3339,3314,3279,3269,-45
10007100028,1961,1930,1871,1850,-80
10007100029,1401,1359,1358,1355,-4
10007100030,857,837,820,808,-29
10007100031,2359,2364,2350,2334,-30
10007100032,2691,2669,2670,2634,-35
10007100033,2430,2455,2452,2428,-27
10007100034,2115,2092,2065,2038,-54
10007100035,2075,2073,2072,2051,-22
10007100036,2845,2788,2732,2685,-103
10007100037,3504,3484,3573,3622,138
10007100038,2893,2907,2922,2901,-6
10007100039,2975,3035,3120,3102,67
10007100040,1828,1795,1795,1780,-15
10007100041,2784,2787,2758,2737,-50
10007020001,1382,1390,1379,1356,-34
10007020002,592,595,584,578,-17
10007020003,1015,979,989,1005,26
10007020004,1082,1086,1072,1052,-34
10007020005,9800,9921,10084,10208,287
10007020006,6461,6417,6407,6395,-22
10007020007,6173,6256,6304,6291,35
10007020008,5349,5406,5409,5417,11
10007020009,656,637,624,617,-20
10007020010,1007,1003,985,960,-43
10007020011,1434,1404,1389,1349,-55
10007020012,1321,1294,1305,1278,-16
10007020013,1518,1509,1519,1495,-14
10007020014,339,358,350,339,-19
10007020015,865,862,841,816,-46
10007020016,762,746,750,740,-6
10007020017,1181,1171,1176,1151,-20
10007020018,2762,2783,2823,2788,5
10007020019,4767,4783,4753,4745,-38
10007020020,3234,3202,3162,3157,-45
10007020021,4939,4886,4924,4895,9
10007020022,5117,5134,5111,5032,-102
10007020023,3773,3785,3785,3777,-8
10007020024,2583,2582,2595,2597,15
10007020025,3653,3648,3610,3590,-58
10007020026,4271,4282,4290,4265,-17
10007020027,2354,2373,2437,2457,84
10007020028,2918,2853,2835,2822,-31
10007020029,5491,5473,5439,5378,-95
10007030001,7520,7501,7522,7583,82
10007030002,5187,5263,5286,5307,44
10007030003,513,498,483,484,-14
10007030004,2274,2275,2222,2175,-100
10007030005,4031,3984,3906,3842,-142
10007030006,3373,3366,3333,3367,1
10007030007,2047,2041,2047,2046,5
10007030008,1006,1004,1011,989,-15
10007030009,2676,2649,2630,2588,-61
10007030010,3363,3340,3341,3361,21
10007030011,1751,1733,1700,1681,-52
10007030012,2132,2110,2141,2135,25
10007030013,2605,2604,2603,2567,-37
10007030014,1610,1613,1604,1578,-35
10007030015,6673,6731,6763,6762,31
10007030016,2313,2281,2273,2271,-10
10007030017,3073,3069,3096,3078,9
10007030018,2234,2217,2268,2262,45
10007030019,4251,4305,4322,4301,-4
10007030020,1092,1089,1093,1076,-13
10007030021,2777,2743,2745,2722,-21
10007030022,2819,2745,2713,2696,-49
10007030023,1336,1328,1325,1311,-17
10007030024,3443,3406,3369,3327,-79
10007030025,5092,5134,5170,5140,6
10007030026,2057,2050,2035,2040,-10
10007030027,1024,1003,972,959,-44
10007030028,1406,1367,1354,1337,-30
10007030029,2323,2399,2381,2384,-15
10007030030,3692,3680,3626,3608,-72
10007030031,1939,1914,1871,1819,-95
10007030032,3354,3340,3325,3299,-41
10007190001,2228,2294,2287,2302,8
10007190002,951,950,938,932,-18
10007190003,685,659,631,617,-42
10007190004,807,785,753,753,-32
10007190005,1697,1680,1645,1649,-31
10007190006,1527,1542,1507,1496,-46
10007190007,2740,2715,2710,2695,-20
10007190008,3672,3657,3674,3729,72
10007190009,1516,1553,1550,1530,-23
10007190010,5636,5625,5628,5572,-53
10007190011,2023,1982,2030,2076,94
10007190012,3158,3179,3263,3295,116
10007190013,2274,2321,2303,2318,-3
10007190014,2386,2353,2391,2383,30
10007190015,2055,2026,2038,2011,-15
10007110001,1512,1534,1516,1473,-61
10007110002,755,762,748,730,-32
10007110003,2518,2506,2542,2534,28
10007110004,500,522,498,500,-22
10007110005,4398,4372,4393,4447,75
10007110006,2864,2836,2864,2861,25
10007110007,4290,4226,4275,4241,15
10007110008,1690,1680,1689,1708,28
10007110009,3685,3695,3656,3611,-84
10007110010,3046,2998,2955,2916,-82
10007110011,2711,2719,2759,2738,19
10007110012,1012,978,956,946,-32
10007110013,2120,2113,2110,2127,14
10007110014,2860,2822,2782,2739,-83
10007110015,1047,1003,981,967,-36
10007110016,1583,1601,1609,1591,-10
10007110017,2217,2186,2183,2184,-2
10007110018,5946,5954,5927,5833,-121
10007110019,779,751,742,730,-21
10007110020,1524,1492,1461,1449,-43
10007110021,807,813,784,781,-32
10007110022,1652,1616,1598,1579,-37
10007110023,1480,1460,1435,1436,-24
10007110024,2618,2607,2596,2579,-28
10007110025,2072,2119,2126,2114,-5
10007120001,989,980,965,935,-45
10007120002,1306,1246,1207,1164,-82
10007120003,860,872,892,872,0
10007120004,1803,1777,1743,1701,-76
10007120005,1720,1698,1674,1637,-61
10007120006,1531,1522,1492,1451,-71
10007120007,2081,2046,2042,2014,-32
10007120008,697,688,671,654,-34
10007120009,4102,4083,4044,4011,-72
10007120010,2878,2853,2864,2833,-20
10007120011,1261,1247,1247,1226,-21
10007120012,1436,1407,1367,1344,-63
10007120013,2353,2320,2310,2297,-23
10007120014,2759,2775,2809,2803,28
10007120015,1854,1820,1795,1769,-51
10007120016,1543,1508,1511,1470,-38
10007120017,2154,2151,2140,2169,18
10007120018,5123,5112,5049,5062,-50
10007120019,1524,1505,1514,1483,-22
10007120020,1864,1863,1840,1809,-54
10007120021,1058,1081,1084,1052,-29
10007120022,994,987,984,961,-26
10007200001,2567,2507,2460,2436,-71
10007200002,4184,4189,4148,4125,-64
10007200003,1784,1794,1800,1839,45
10007200004,3687,3699,3652,3598,-101
10007200005,2012,1990,1967,1918,-72
10007200006,1548,1545,1580,1557,12
10007200007,1205,1196,1183,1163,-33
10007200008,1191,1173,1161,1129,-44
10007200009,1352,1336,1351,1327,-9
10007200010,1935,1910,1925,1930,20
10007200011,4004,4036,4054,4070,34
10007200012,3039,3025,2993,2977,-48
10007200013,1572,1557,1529,1503,-54
10007200014,1838,1825,1781,1750,-75
10007200015,1448,1443,1425,1397,-46
10007200016,914,899,889,895,-4
10007200017,1712,1723,1721,1703,-20
10007200018,1482,1449,1430,1414,-35
10007200019,1228,1208,1197,1205,-3
10007200020,4161,4079,3992,3984,-95
10007200021,1084,1071,1067,1056,-15
10007200022,1347,1324,1278,1271,-53
10007200023,1023,998,986,985,-13
10007200024,1478,1435,1425,1410,-25
10007200025,1257,1235,1200,1189,-46
10007200026,1114,1090,1086,1061,-29
10007200027,814,800,795,795,-5
10007040001,2772,2771,2726,2701,-70
10007040002,1449,1476,1456,1451,-25
10007040003,2808,2784,2797,2813,29
10007040004,1503,1510,1495,1469,-41
10007040005,1437,1415,1395,1428,13
10007040006,2263,2234,2222,2213,-21
10007040007,3108,3099,3078,3021,-78
10007040008,1588,1571,1564,1569,-2
10007050001,2035,2020,2054,2036,16
10007050002,1362,1329,1321,1328,-1
10007050003,1618,1626,1746,1819,193
10007050004,2314,2306,2381,2403,97
10007050005,2417,2421,2402,2404,-17
10007050006,1519,1512,1495,1499,-13
10007050007,2175,2185,2189,2192,7
10007050008,2107,2089,2079,2096,7
10007050009,3171,3170,3160,3144,-26
10007050010,6236,6272,6292,6354,82
10007050011,2608,2685,2731,2829,144
10007050012,2903,3046,3154,3255,209
10007050013,3751,3746,3749,3720,-26
10007050014,2741,2714,2696,2661,-53
10007060001,1761,1752,1718,1730,-22
10007060002,1649,1698,1714,1686,-12
10007060003,1438,1430,1387,1385,-45
10007060004,1735,1731,1780,1790,59
10007060005,1388,1361,1342,1339,-22
10007060006,1476,1463,1446,1432,-31
10007060007,1636,1621,1631,1641,20
10007060008,963,957,971,964,7
10007060009,2857,2851,2842,2793,-58
10007060010,3066,3034,3004,3011,-23
10007060011,3001,2958,3003,3003,45
10007060012,1448,1433,1404,1389,-44
10007060013,1250,1243,1228,1215,-28
10007060014,2697,2689,2629,2598,-91
10007060015,2343,2300,2258,2235,-65
10007060016,2807,2808,2780,2756,-52
10007060017,1607,1588,1553,1540,-48
10007060018,1558,1540,1542,1513,-27
10007060019,4276,4309,4242,4219,-90
10007060020,3087,3052,3042,3048,-4
10007060021,2889,2886,2894,2828,-58
10007060022,2400,2355,2338,2284,-71
10007070001,2102,2083,2067,2030,-53
10007070002,2502,2453,2428,2370,-83
10007070003,3221,3249,3241,3263,14
10007070004,2206,2215,2170,2145,-70
10007070005,1682,1711,1696,1694,-17
10007070006,4751,4746,4722,4696,-50
10007070007,3757,3738,3676,3621,-117
10007070008,2653,2635,2660,2643,8
10007070009,1630,1612,1629,1687,75
10007070010,5728,5758,5754,5764,6
10007070011,2513,2482,2477,2436,-46
10007070012,2015,2002,1991,1988,-14
10007070013,2078,2074,2053,2069,-5
10007070014,2519,2533,2504,2466,-67
10007080001,3995,3932,3859,3822,-110
10007080002,2118,2084,2066,2040,-44
10007080003,2822,2790,2753,2697,-93
10007080004,1212,1241,1228,1223,-18
10007080005,1660,1665,1663,1669,4
10007080006,2097,2175,2171,2151,-24
10007080007,830,846,838,802,-44
10007080008,2106,2081,2121,2125,44
10007080009,6124,6121,6011,6009,-112
10007080010,3441,3483,3498,3523,40
10007080011,5312,5293,5291,5290,-3
10007080012,1538,1543,1514,1514,-29
10007080013,4073,4060,4003,3989,-71
10007080014,1052,1040,1042,1033,-7
10007080015,1117,1093,1087,1043,-50
10007080016,2293,2263,2275,2252,-11
10007080017,2234,2247,2235,2183,-64
10007080018,1900,1896,1911,1867,-29
10007090001,2037,1994,1981,1984,-10
10007090002,1673,1652,1643,1612,-40
10007090003,2097,2084,2090,2070,-14
10007090004,2881,2848,2864,2860,12
10007090005,2742,2720,2700,2689,-31
10007090006,1873,1879,1860,1845,-34
10007090007,1088,1067,1058,1057,-10
10007090008,1336,1315,1312,1286,-29
10007090009,750,738,738,719,-19
10007090010,1901,1924,1897,1884,-40
10007090011,1162,1158,1133,1139,-19
10007090012,1384,1386,1328,1298,-88
10007090013,1010,996,984,971,-25
10007090014,1137,1139,1117,1105,-34
10007090015,684,683,678,669,-14
10007130001,3832,3875,3935,4172,297
10007130002,1845,1830,1788,1833,3
10007130003,1641,1670,1700,1746,76
10007130004,1352,1355,1352,1412,57
10007130005,1277,1271,1261,1300,29
10007130006,3340,3331,3400,3668,337
10007130007,3502,3480,3452,3593,113
10007130008,2972,2954,2926,2998,44
10007130009,1734,1777,1797,1853,76
10007130010,1687,1687,1658,1703,16
10007130011,1657,1673,1666,1687,14
10007130012,2329,2337,2328,2355,18
10007130013,1798,1812,1835,1848,36
10007130014,2932,2907,2924,3003,96
10007130015,2568,2620,2674,2773,153
10007130016,2404,2389,2428,2513,124
10007140001,2047,2041,2028,1991,-50
10007140002,1824,1849,1842,1825,-24
10007140003,1445,1472,1455,1432,-40
10007140004,1110,1092,1064,1035,-57
10007140005,2014,1981,1978,2020,39
10007140006,1090,1069,1060,1032,-37
10007140007,1509,1513,1500,1486,-27
10007140008,1260,1258,1255,1275,17
10007140009,784,768,757,750,-18
10007140010,1451,1449,1440,1421,-28
10007140011,2091,2071,2080,2100,29
10007140012,2456,2447,2403,2387,-60
10007140013,1401,1423,1404,1402,-21
10007140014,492,487,490,488,1
10007140015,1274,1258,1243,1221,-37
10007140016,1028,1021,995,984,-37
10007140017,1675,1653,1641,1634,-19
10007140018,1001,989,965,942,-47
10007140019,1761,1761,1751,1730,-31
10007140020,1797,1777,1778,1754,-23
10007140021,1544,1541,1522,1506,-35
10007140022,1533,1540,1532,1504,-36
10007150001,4269,4335,4317,4250,-85
10007150002,1483,1486,1449,1440,-46
10007150003,1886,1818,1812,1839,21
10007150004,1477,1455,1432,1416,-39
10007150005,2026,2029,2014,2020,-9
10007150006,2201,2207,2258,2235,28
10007150007,1663,1660,1639,1618,-42
10007150008,2459,2443,2414,2413,-30
10007150009,2731,2703,2719,2697,-6
10007150010,697,700,750,750,50
10007150011,1425,1454,1446,1456,2
10007150012,1842,1814,1834,1795,-19
10007150013,1228,1231,1250,1237,6
10007150014,1114,1163,1155,1128,-35
10007150015,1562,1550,1536,1496,-54
10007150016,2159,2140,2131,2111,-29
10007150017,1614,1592,1668,1689,97
10007150018,1045,1036,1029,1006,-30
10007150019,890,862,843,811,-51
10007150020,1065,1067,1038,1044,-23
10007160001,969,962,956,958,-4
10007160002,1888,1855,1841,1839,-16
10007160003,2256,2244,2218,2207,-37
10007160004,2563,2567,2561,2571,4
10007160005,2111,2078,2041,1971,-107
10007160006,1712,1712,1691,1663,-49
10007160007,1267,1254,1240,1258,4
10007160008,1267,1276,1275,1297,21
10007160009,3289,3250,3256,3285,35
10007160010,1664,1622,1622,1600,-22
10007160011,1442,1438,1398,1377,-61
10007160012,1960,1921,1886,1876,-45
10007160013,2272,2250,2280,2274,24
10007160014,1916,1918,1886,1848,-70
10007160015,1654,1628,1628,1604,-24
10007160016,1027,1020,1008,962,-58
10007160017,852,837,842,823,-14
10007160018,927,902,874,847,-55
10007160019,784,773,750,743,-30
10007160020,974,967,965,943,-24
10007160021,975,965,949,930,-35
10007160022,780,780,759,741,-39
10007160023,1257,1230,1242,1232,2
10007160024,1528,1513,1483,1451,-62
10007170001,3322,3296,3304,3301,5
10007170002,1799,1766,1727,1702,-64
10007170003,1359,1349,1342,1310,-39
10007170004,5514,5514,5419,5363,-151
10007170005,1103,1096,1076,1062,-34
10007170006,1241,1258,1261,1239,-19
10007170007,3207,3230,3263,3287,57
10007170008,2452,2434,2406,2377,-57
10007170009,886,855,853,875,20
10007170010,1132,1176,1144,1148,-28
10007170011,1947,1934,1946,1942,8
10007170012,1124,1137,1146,1145,8
10007170013,1554,1549,1545,1539,-10
10007170014,1638,1627,1612,1608,-19
10007170015,1194,1177,1146,1113,-64
10007170016,1175,1166,1144,1171,5
10007170017,1472,1457,1448,1441,-16
10007170018,972,961,950,919,-42
10007170019,1955,1910,1897,1897,-13
10007170020,1151,1128,1112,1113,-15
10007170021,1770,1762,1744,1739,-23
10007170022,1245,1193,1199,1207,14
10007170023,1443,1443,1428,1476,33
10007170024,2489,2464,2461,2462,-2
10007180001,956,949,942,915,-34
10007180002,1123,1107,1085,1057,-50
10007180003,727,720,726,723,3
10007180004,735,730,704,697,-33
10007180005,1068,1058,1025,1000,-58
10007180006,1125,1101,1093,1084,-17
10007180007,994,985,946,923,-62
10007180008,530,522,516,494,-28
10007180009,1180,1160,1154,1132,-28
10007180010,943,923,913,890,-33
10007180011,922,920,907,907,-13
10007180012,902,894,869,875,-19
10007180013,785,771,757,749,-22
10007180014,724,735,708,696,-39
10007180015,649,645,624,626,-19
10007180016,1170,1166,1129,1134,-32
10007180017,792,767,745,740,-27
10007210001,1521,1503,1490,1454,-49
10007210002,895,991,926,916,-75
10007210003,3153,3137,3120,3105,-32
10007210004,1286,1265,1246,1238,-27
10007210005,879,852,836,817,-35
10007210006,1285,1259,1225,1197,-62
10007210007,1365,1386,1398,1379,-7
10007210008,742,743,729,720,-23
10007210009,1622,1618,1601,1586,-32
10007210010,1569,1577,1562,1521,-56
10007210011,1894,1886,1857,1828,-58
10007210012,1441,1426,1420,1467,41
10007210013,2082,2076,2057,2040,-36
10007210014,1096,1079,1074,1073,-6
10007210015,1033,1006,1014,986,-20
10007210016,1623,1583,1539,1516,-67
10007210017,1894,1909,1879,1848,-61
10007210018,291,297,294,292,-5
10007210019,743,722,702,691,-31
10007210020,1048,1021,1024,1017,-4
10007220001,2921,2907,2913,2878,-29
10007220002,2075,2082,2088,2076,-6
10007220003,1941,1891,1881,1866,-25
10007220004,2746,2708,2672,2629,-79
10007220005,1569,1560,1541,1512,-48
10007220006,1902,1914,1912,1917,3
10007220007,4018,4008,3988,3965,-43
10007220008,2654,2699,2747,2708,9
10007220009,865,862,850,827,-35
10007220010,660,663,649,636,-27
10007220011,1796,1765,1743,1717,-48
10007220012,1198,1182,1181,1161,-21
10007220013,926,925,922,920,-5
10007220014,1296,1297,1294,1268,-29
10007220015,1742,1724,1712,1712,-12
10007220016,1250,1235,1226,1223,-12
10007220017,1083,1086,1075,1057,-29
10007230001,1097,1070,1040,1022,-48
10007230002,476,465,461,452,-13
10007230003,865,855,852,842,-13
10007230004,651,632,622,599,-33
10007230005,1140,1158,1144,1141,-17
10007230006,2597,2564,2556,2523,-41
10007230007,1575,1552,1553,1546,-6
10007230008,538,531,523,529,-2
10007230009,744,734,715,700,-34
10007230010,824,820,826,849,29
10007230011,1131,1124,1106,1079,-45
10007230012,643,641,622,629,-12
10007230013,643,643,627,619,-24
10007230014,914,883,842,833,-50
10007230015,2493,2488,2431,2411,-77
10007230016,790,794,781,750,-44
10007230017,833,823,835,834,11
10007230018,763,742,739,737,-5
10007230019,1502,1498,1474,1463,-35
10007230020,1956,1945,1951,1930,-15
10007230021,1691,1639,1656,1631,-8
10007230022,1186,1217,1195,1164,-53
10007230023,2424,2430,2394,2354,-76
10007230024,862,862,858,855,-7
10007230025,1583,1612,1570,1520,-92
10007230026,3793,3767,3711,3708,-59
10007240001,1252,1216,1186,1181,-35
10007240002,1246,1227,1201,1192,-35
10007240003,1542,1528,1537,1496,-32
10007240004,1006,984,944,933,-51
10007240005,1150,1115,1089,1073,-42
10007240006,1277,1250,1217,1196,-54
10007240007,1480,1480,1460,1441,-39
10007240008,802,794,767,765,-29
10007240009,773,745,733,723,-22
10007240010,1196,1169,1149,1143,-26
10007240011,1014,1002,976,967,-35
10007240012,1413,1406,1380,1347,-59
10007240013,1001,1005,974,964,-41
10007240014,1082,1075,1043,1011,-64
10007240015,753,721,703,687,-34
10007250001,1395,1408,1389,1378,-30
10007250002,2422,2405,2403,2405,0
10007250003,882,857,828,815,-42
10007250004,899,876,869,858,-18
10007250005,1832,1807,1815,1819,12
10007250006,780,760,742,742,-18
10007250007,1300,1290,1286,1291,1
10007250008,1319,1280,1272,1242,-38
10007250009,565,561,534,533,-28
10007250010,978,963,960,934,-29
10007250011,749,744,722,700,-44
10007250012,655,641,617,590,-51
10007250013,900,894,888,898,4
10007250014,627,609,601,603,-6
10007260001,2140,2136,2096,2100,-36
10007260002,1651,1653,1649,1648,-5
10007260003,1411,1391,1360,1332,-59
10007260004,1776,1782,1769,1755,-27
10007260005,841,813,824,813,0
10007260006,1776,1775,1764,1714,-61
10007260007,981,979,968,951,-28
10007260008,1050,1014,999,973,-41
10007260009,2407,2391,2337,2331,-60
10007260010,827,819,793,782,-37
10007260011,1828,1802,1778,1787,-15
10007260012,2169,2141,2130,2104,-37
10007260013,999,996,977,963,-33
10007260014,2192,2182,2160,2186,4
10007260015,2211,2176,2139,2116,-60
10007260016,1479,1443,1415,1408,-35
10007260017,2322,2290,2276,2259,-31
10007260018,976,964,972,955,-9
10007260019,1024,1013,1005,981,-32
10008010001,1118,1083,1066,1044,-39
10008010002,1707,1702,1695,1673,-29
10008010003,986,972,960,965,-7
10008010004,581,589,572,557,-32
10008010005,679,669,651,675,6
10008010006,444,434,418,406,-28
10008010007,1135,1139,1126,1134,-5
10008010008,3097,3078,3041,3003,-75
10008010009,8348,8255,8288,8301,46
10008010010,5549,5591,5615,5625,34
10008010011,450,453,438,442,-11
10008010012,7065,6979,7023,7005,26
10008010013,2432,2410,2427,2405,-5
10008010014,1185,1160,1189,1179,19
10008010015,6459,6504,6508,6488,-16
10008010016,3416,3339,3267,3231,-108
10008010017,2434,2440,2453,2463,23
10008010018,5207,5190,5198,5277,87
10008010019,2231,2197,2181,2146,-51
10008010020,926,912,888,886,-26
10008010021,727,710,681,673,-37
10008010022,1253,1228,1205,1192,-36
10008010023,6301,6249,6215,6247,-2
10008010024,5915,5871,5950,5925,54
10008010025,3298,3305,3236,3237,-68
10008010026,3515,3487,3523,3476,-11
10008010027,7219,7211,7159,7214,3
10008010028,2720,2706,2719,2752,46
10008010029,8021,7998,8037,8139,141
10008010030,1694,1694,1655,1654,-40
10008010031,1005,970,921,874,-96
10008010032,1270,1206,1158,1113,-93
10008010033,1145,1126,1080,1039,-87
10008010034,648,662,656,641,-21
10008020001,3130,3086,3028,3000,-86
10008020002,896,894,868,853,-41
10008020003,3769,3681,3627,3580,-101
10008020004,2936,2887,2892,2876,-11
10008020005,2664,2612,2573,2505,-107
10008020006,1177,1140,1117,1100,-40
10008020007,4297,4261,4239,4205,-56
10008020008,6689,6630,6604,6652,22
10008020009,1064,1050,1070,1062,12
10008020010,9045,9047,9081,9053,6
10008020011,4481,4478,4483,4462,-16
10008020012,1185,1183,1162,1147,-36
10008020013,1344,1327,1342,1337,10
10008020014,1367,1371,1347,1342,-29
10008020015,1142,1141,1136,1125,-16
10008020016,334,334,312,310,-24
10008020017,1644,1607,1593,1571,-36
10008020018,1713,1705,1694,1665,-40
10008020019,2082,2084,2075,2057,-27
10008020020,1616,1599,1626,1596,-3
10008020021,756,756,749,743,-13
10008020022,1074,1060,1055,1047,-13
10008020023,1298,1293,1275,1248,-45
10008020024,668,662,652,629,-33
10008020025,1135,1139,1109,1080,-59
10008020026,3272,3247,3200,3234,-13
10008020027,1885,1889,1899,1900,11
10008020028,3044,2972,2900,2914,-58
10008020029,1935,1916,1875,1842,-74
10008020030,3854,3830,3791,3749,-81
10008020031,3149,3140,3138,3123,-17
10008020032,3869,3832,3805,3789,-43
10008020033,2519,2487,2472,2395,-92
10008030001,2552,2509,2487,2497,-12
10008030002,2579,2480,2483,2476,-4
10008030003,1366,1323,1334,1308,-15
10008030004,7651,7661,7693,7738,77
10008030005,8613,8585,8595,8686,101
10008030006,7888,7848,8063,8082,234
10008030007,7109,7054,7061,7093,39
10008030008,4727,4714,4758,4718,4
10008030009,5299,5250,5297,5374,124
10008030010,2761,2793,2804,2820,27
10008030011,3462,3362,3329,3285,-77
10008030012,3558,3591,3637,3611,20
10008030013,4083,4036,4174,4175,139
10008030014,3349,3404,3397,3454,50
10008030015,1757,1758,1726,1725,-33
10008030016,2612,2585,2554,2539,-46
10008030017,2245,2200,2168,2097,-103
10008030018,2410,2375,2372,2327,-48
10008030019,4849,4796,4808,4727,-69
10008030020,1899,1879,1864,1850,-29
10008030021,1175,1157,1144,1132,-25
10008030022,2646,2623,2616,2575,-48
10008030023,1250,1234,1244,1235,1
10008030024,774,784,750,758,-26
10008030025,2853,2793,2863,2857,64
10008030026,4547,4484,4439,4407,-77
10008030027,3861,3841,3948,3943,102
10008040001,2367,2304,2258,2223,-81
10008040002,722,699,688,667,-32
10008040003,5354,5294,5311,5375,81
10008040004,4255,4214,4164,4107,-107
10008040005,2032,2004,1966,2010,6
10008040006,1414,1402,1410,1387,-15
10008040007,4435,4404,4407,4350,-54
10008040008,1115,1088,1043,1011,-77
10008040009,1580,1593,1595,1634,41
10008040010,1014,999,991,968,-31
10008040011,3380,3319,3266,3233,-86
10008040012,1989,1983,1972,1920,-63
10008040013,986,971,965,938,-33
10008040014,5967,5932,5891,5904,-28
10008040015,2155,2130,2092,2094,-36
10008040016,1555,1582,1580,1566,-16
10008040017,1344,1323,1284,1237,-86
10008040018,673,678,677,667,-11
10008040019,475,487,476,466,-21
10008040020,679,675,662,644,-31
10008040021,672,667,655,640,-27
10008040022,908,879,849,826,-53
10008040023,651,637,618,610,-27
10008040024,504,493,485,489,-4
10008040025,1019,997,965,965,-32
10008040026,793,794,759,745,-49
10008040027,4234,4237,4191,4168,-69
10008040028,2788,2755,2712,2620,-135
10008050001,1242,1220,1217,1212,-8
10008050002,1036,1037,1019,1019,-18
10008050003,628,633,624,615,-18
10008050004,1395,1383,1340,1329,-54
10008050005,537,536,528,514,-22
10008050006,579,581,572,550,-31
10008050007,1000,1008,991,978,-30
10008050008,1684,1652,1612,1595,-57
10008050009,1099,1076,1076,1051,-25
10008050010,643,646,624,603,-43
10008050011,1061,1032,1012,995,-37
10008060001,1227,1200,1196,1175,-25
10008060002,4053,4009,3977,3975,-34
10008060003,2654,2602,2585,2564,-38
10008060004,1834,1811,1804,1797,-14
10008060005,1155,1147,1126,1105,-42
10008060006,1138,1115,1108,1089,-26
10008060007,4942,4893,4833,4817,-76
10008060008,1891,1883,1872,1829,-54
10008060009,1070,1042,1030,1014,-28
10008060010,1448,1430,1424,1400,-30
10008060011,2092,2067,2064,2020,-47
10008060012,1053,1047,1036,1026,-21
10008060013,860,839,816,795,-44
10008060014,1075,1039,1041,1021,-18
10008060015,1328,1295,1289,1272,-23
10008060016,1831,1812,1771,1770,-42
10008060017,1773,1753,1730,1730,-23
10008060018,1395,1380,1374,1343,-37
10008060019,1016,1005,998,972,-33
10008060020,997,1000,1007,990,-10
10008060021,906,886,873,855,-31
10008060022,2034,2001,1990,1963,-38
10008060023,1024,1009,1007,985,-24
10008070001,2130,2120,2083,2051,-69
10008070002,1613,1589,1589,1561,-28
10008070003,1488,1463,1452,1415,-48
10008070004,2144,2137,2141,2128,-9
10008070005,1186,1170,1161,1150,-20
10008070006,1716,1689,1685,1658,-31
10008070007,1022,1011,996,997,-14
10008070008,681,683,675,673,-10
10008070009,1559,1550,1510,1475,-75
10008070010,1811,1824,1808,1764,-60
10008070011,861,858,839,813,-45
10008070012,770,770,759,750,-20
10008070013,827,823,811,796,-27
10008080001,905,895,878,853,-42
10008080002,525,521,504,500,-21
10008080003,918,903,879,870,-33
10008080004,742,723,699,698,-25
10008080005,775,766,753,743,-23
10008080006,1998,1958,1925,1905,-53
10008080007,319,320,316,312,-8
10008080008,763,748,727,709,-39
10008080009,558,553,538,540,-13
10008080010,1518,1498,1494,1499,1
10008080011,1205,1203,1210,1182,-21
10008080012,996,995,982,961,-34
10008080013,771,757,757,742,-15
10008080014,724,726,744,738,12
10008080015,585,572,560,539,-33
10008080016,512,513,502,493,-20
10008080017,495,498,506,511,13
10008080018,533,531,521,506,-25
10008090001,1803,1774,1758,1767,-7
10008090002,2372,2324,2275,2254,-70
10008090003,1161,1142,1140,1110,-32
10008090004,1611,1589,1596,1576,-13
10008090005,1236,1240,1215,1189,-51
10008090006,1433,1426,1423,1408,-18
10008090007,1125,1115,1108,1109,-6
10008090008,748,741,731,688,-53
10008090009,848,825,814,820,-5
10008090010,991,963,952,953,-10
10008090011,1013,1013,998,995,-18
10008090012,638,623,620,616,-7
10008090013,967,978,981,981,3
10008100001,1963,1949,1927,1927,-22
10008100002,2053,2069,2029,1987,-82
10008100003,770,763,735,720,-43
10008100004,2131,2093,2057,2007,-86
10008100005,1600,1574,1536,1530,-44
10008100006,776,794,789,777,-17
10008100007,2068,2045,2008,1985,-60
10008100008,893,899,887,870,-29
10008100009,1292,1277,1247,1246,-31
10008100010,1737,1730,1672,1631,-99
10008100011,1879,1811,1773,1723,-88
10008100012,811,789,770,761,-28
10008100013,830,836,815,801,-35
10008110001,839,827,805,785,-42
10008110002,540,536,522,482,-54
10008110003,1809,1780,1723,1697,-83
10008110004,692,688,670,664,-24
10008110005,1002,1004,972,951,-53
10008110006,1155,1151,1158,1164,13
10008110007,1169,1135,1112,1078,-57
10008110008,1603,1581,1544,1547,-34
10008110009,1436,1393,1425,1380,-13
10008110010,517,498,486,481,-17
10008110011,752,730,719,715,-15
10008110012,239,234,224,224,-10
10008110013,377,377,346,338,-39
10008110014,1233,1208,1184,1170,-38
10008110015,993,966,951,930,-36
10008110016,368,358,345,344,-14
10008110017,928,904,910,903,-1
10008110018,297,297,295,293,-4
10008110019,1854,1829,1856,1834,5
10008120001,1520,1521,1490,1471,-50
10008120002,1132,1145,1143,1140,-5
10008120003,785,792,791,783,-9
10008120004,1740,1721,1670,1665,-56
10008120005,584,575,556,542,-33
10008120006,843,832,821,804,-28
10008120007,1722,1728,1695,1678,-50
10008120008,1884,1887,1886,1918,31
10008120009,1683,1662,1645,1622,-40
10008120010,754,771,736,714,-57
10008120011,1277,1268,1249,1237,-31
10008120012,806,813,801,786,-27
10008120013,752,750,758,756,6
10008120014,771,765,765,762,-3
10008130001,1050,1073,1099,1106,33
10008130002,1181,1205,1225,1245,40
10008130003,1372,1399,1411,1424,25
10008130004,469,474,471,478,4
10008130005,641,648,631,613,-35
10008130006,952,949,943,918,-31
10008130007,804,798,801,778,-20
10008130008,1434,1459,1438,1430,-29
10008130009,1953,1970,1959,1927,-43
10008130010,1520,1552,1517,1494,-58
10008130011,1234,1253,1255,1233,-20
10008130012,853,857,860,854,-3
10008130013,817,841,850,857,16
10008130014,65,59,51,46,-13
10008130015,619,618,589,595,-23
10008130016,784,814,805,820,6
10009010001,1709,1722,1727,1723,1
10009010002,1302,1335,1347,1329,-6
10009010003,746,731,728,704,-27
10009010004,706,707,707,696,-11
10009010005,962,973,972,937,-36
10009010006,923,900,917,898,-2
10009010007,871,866,846,807,-59
10009010008,5895,5963,6004,6088,125
10009010009,3877,3831,3741,3733,-98
10009010010,3381,3356,3294,3262,-94
10009010011,2137,2154,2137,2108,-46
10009010012,4224,4224,4206,4158,-66
10009010013,4973,4948,4958,4962,14
10009010014,2752,2693,2699,2672,-21
10009010015,749,761,766,768,7
10009010016,2655,2637,2598,2560,-77
10009010017,622,624,615,598,-26
10009010018,2786,2859,2890,2938,79
10009010019,1814,1750,1798,1808,58
10009010020,2769,2776,2745,2751,-25
10009010021,2007,2025,2023,2104,79
10009010022,6417,6455,6518,6536,81
10009010023,6454,6454,6456,6395,-59
10009010024,2110,2111,2124,2109,-2
10009010025,1271,1248,1229,1228,-20
10009010026,5250,5266,5234,5227,-39
10009010027,1301,1280,1267,1265,-15
10009010028,2305,2381,2439,2530,149
10009010029,3734,3696,3758,3778,82
10009010030,3426,3488,3473,3566,78
10009010031,1328,1321,1280,1266,-55
10009010032,5802,2863,2881,2890,27
10009010033,4454,4453,4474,4499,46
10009010034,3534,3560,3576,3587,27
10009010035,2789,2739,2712,2709,-30
10009010036,2759,2681,2603,2587,-94
10009010037,4382,4418,4443,4505,87
10009010038,3391,3417,3517,3501,84
10009020001,1424,1392,1385,1377,-15
10009020002,6248,2560,2529,2489,-71
10009020003,2646,2629,2587,2603,-26
10009020004,1772,1768,1768,1766,-2
10009020005,1241,1471,1442,1383,-88
10009020006,3214,3234,3239,3230,-4
10009020007,1495,1520,1506,1498,-22
10009020008,903,876,861,852,-24
10009020009,984,974,971,942,-32
10009020010,787,783,772,774,-9
10009020011,1297,1289,1245,1224,-65
10009020012,1966,1963,1956,1944,-19
10009020013,1110,1105,1094,1085,-20
10009020014,3198,3143,3137,3194,51
10009020015,2655,2631,2572,2561,-70
10009020016,6615,3841,3903,3988,147
10009020017,1017,995,986,976,-19
10009020018,882,875,879,875,0
10009020019,992,968,946,927,-41
10009020020,1726,1697,1676,1676,-21
10009020021,1777,1744,1735,1698,-46
10009020022,992,984,966,941,-43
10009030001,1146,1099,1082,1087,-12
10009030002,2007,1956,1947,1932,-24
10009030003,3435,3403,3395,3331,-72
10009030004,3558,3537,3562,3548,11
10009030005,3199,3156,3088,3068,-88
10009030006,3992,3944,3889,3829,-115
10009030007,1747,1718,1674,1647,-71
10009030008,5715,5853,5986,6005,152
10009030009,2856,2857,2884,2921,64
10009030010,4835,4893,4942,4886,-7
10009030011,2435,2417,2434,2451,34
10009030012,1323,1357,1365,1355,-2
10009030013,1529,1536,1565,1573,37
10009030014,1007,1037,1019,1024,-13
10009030015,1750,1902,2130,2333,431
10009030016,1772,1762,1715,1696,-66
10009030017,1019,1018,1010,1013,-5
10009030018,3093,3069,3061,3046,-23
10009030019,940,941,944,963,22
10009030020,2011,2015,2009,1989,-26
10009030021,1892,1899,1877,1867,-32
10009030022,3774,3774,3878,3954,180
10009030023,2756,2695,2662,2628,-67
10009030024,3038,3000,2963,2943,-57
10009030025,1604,1569,1556,1529,-40
10009030026,1745,1758,1764,1759,1
10009030027,605,635,608,605,-30
10009030028,4670,4602,4533,4480,-122
10009030029,1439,1442,1452,1437,-5
10009040001,1933,1916,1864,1806,-110
10009040002,2088,2083,2069,2075,-8
10009040003,2727,2720,2681,2656,-64
10009040004,3611,3582,3587,3516,-66
10009040005,404,394,374,367,-27
10009040006,676,682,684,675,-7
10009040007,676,673,652,653,-20
10009040008,1323,1325,1307,1291,-34
10009040009,3453,3500,3585,3600,100
10009040010,5441,5531,5587,5758,227
10009040011,1603,1549,1524,1499,-50
10009040012,1810,1810,1773,1751,-59
10009040013,1091,1129,1129,1152,23
10009040014,1229,1213,1215,1256,43
10009040015,2205,2165,2147,2119,-46
10009040016,1799,1778,1781,1777,-1
10009040017,1974,1957,1912,1880,-77
10009040018,1037,1017,985,966,-51
10009040019,1136,1123,1100,1070,-53
10009040020,1056,1028,1019,990,-38
10009040021,1763,1746,1720,1697,-49
10009040022,1140,1127,1116,1085,-42
10009040023,990,991,974,969,-22
10009040024,865,866,857,833,-33
10009040025,1550,1546,1494,1479,-67
10009040026,1053,1036,1023,1000,-36
10009040027,1611,1577,1564,1543,-34
10009050001,972,959,909,917,-42
10009050002,1101,1085,1060,1052,-33
10009050003,1631,1653,1658,1618,-35
10009050004,1190,1243,1263,1281,38
10009050005,1310,1294,1268,1252,-42
10009050006,1699,1723,1705,1667,-56
10009050007,1517,1481,1451,1423,-58
10009050008,1434,1413,1369,1339,-74
10009050009,1007,973,993,994,21
10009050010,3535,3571,3625,3637,66
10009050011,2177,2151,2093,2083,-68
10009050012,2092,2084,2089,2072,-12
10009050013,1060,1035,999,983,-52
10009050014,2103,2060,2042,2020,-40
10009050015,2685,2664,2657,2645,-19
10009050016,1751,1748,1743,1716,-32
10009050017,1668,1657,1620,1606,-51
10009060001,874,876,858,841,-35
10009060002,778,795,779,757,-38
10009060003,526,510,510,505,-5
10009060004,1061,1042,1028,1025,-17
10009060005,379,376,369,363,-13
10009060006,492,479,462,467,-12
10009060007,445,444,431,413,-31
10009060008,1135,1122,1125,1110,-12
10009060009,586,572,543,534,-38
10009060010,400,391,373,376,-15
10009060011,629,620,586,583,-37
10009060012,1396,1377,1362,1322,-55
10009060013,500,511,509,481,-30
10009060014,5925,5854,5759,5707,-147
10009060015,2125,2147,2119,2089,-58
10009060016,7600,7558,7613,7690,132
10009060017,1320,1313,1302,1295,-18
10009060018,940,911,900,902,-9
10009060019,1603,1582,1562,1530,-52
10009060020,1344,1318,1294,1266,-52
10009060021,1128,1119,1101,1117,-2
10009060022,910,904,853,837,-67
10009060023,650,626,610,592,-34
10009060024,1866,1837,1808,1785,-52
10009060025,3553,3552,3510,3492,-60
10009060026,1085,1085,1068,1057,-28
10009060027,570,544,531,520,-24
10009060028,458,440,432,433,-7
10009070001,1437,1438,1403,1387,-51
10009070002,1229,1216,1243,1246,30
10009070003,1335,1319,1309,1286,-33
10009070004,1720,1652,1634,1593,-59
10009070005,3697,3611,3670,3662,51
10009070006,1735,1697,1669,1637,-60
10009070007,2420,2406,2361,2308,-98
10009070008,823,811,796,779,-32
10009070009,323,308,305,300,-8
10009070010,2445,2465,2446,2438,-27
10009070011,1266,1267,1241,1198,-69
10009070012,1383,1381,1333,1305,-76
10009070013,503,492,472,465,-27
10009070014,646,629,620,609,-20
10009070015,2422,2403,2368,2378,-25
10009070016,784,798,842,841,43
10009070017,2574,2565,2604,2589,24
10009070018,2486,2428,2440,2395,-33
10009070019,1697,1695,1687,1687,-8
10009070020,783,777,759,765,-12
10009080001,865,841,817,806,-35
10009080002,2492,2468,2467,2480,12
10009080003,1192,1177,1156,1115,-62
10009080004,1077,1071,1054,1029,-42
10009080005,2187,2185,2167,2154,-31
10009080006,2082,2073,2053,2044,-29
10009080007,1859,1843,1832,1803,-40
10009080008,1382,1366,1348,1335,-31
10009080009,831,811,809,801,-10
10009080010,698,688,669,667,-21
10009080011,1270,1244,1223,1206,-38
10009080012,883,866,848,847,-19
10009080013,793,784,774,765,-19
10009080014,825,816,794,769,-47
10009080015,827,797,790,783,-14
10009090001,5004,4947,4994,4981,34
10009090002,1026,1015,1002,992,-23
10009090003,1767,1767,1759,1736,-31
10009090004,1398,1367,1348,1314,-53
10009090005,1279,1271,1244,1226,-45
10009090006,2288,2278,2302,2341,63
10009090007,3573,3550,3543,3566,16
10009090008,1475,1458,1457,1440,-18
10009090009,1366,1334,1313,1310,-24
10009090010,2297,2274,2235,2207,-67
10009090011,2072,2048,2015,1951,-97
10009090012,1733,1736,1710,1681,-55
10009090013,1569,1572,1542,1534,-38
10009090014,2092,2086,2060,2032,-54
10009100001,1227,1212,1183,1158,-54
10009100002,4350,4309,4294,4221,-88
10009100003,2617,2570,2525,2441,-129
10009100004,593,592,569,551,-41
10009100005,963,942,935,910,-32
10009100006,3060,3027,2990,2955,-72
10009100007,751,717,712,691,-26
10009100008,1307,1295,1288,1275,-20
10009100009,1234,1222,1177,1139,-83
10009100010,2128,2109,2103,2093,-16
10009110001,1757,1726,1716,1675,-51
10009110002,2095,2062,2016,1993,-69
10009110003,1875,1855,1816,1797,-58
10009110004,1669,1644,1624,1626,-18
10009110005,1325,1303,1281,1266,-37
10009110006,2145,2113,2054,2065,-48
10009110007,1002,992,969,967,-25
10009110008,1065,1043,1028,1008,-35
10009110009,917,896,888,870,-26
10009110010,1825,1773,1746,1729,-44
10009110011,2151,2141,2081,2045,-96
10009110012,995,995,977,962,-33
10009110013,2056,2019,2001,1946,-73
10009110014,1484,1447,1419,1404,-43
10009110015,1076,1051,1042,1042,-9
10009110016,975,1002,960,938,-64
10009110017,1184,1150,1136,1105,-45
10009110018,1659,1643,1617,1591,-52
10009120001,1374,1323,1299,1269,-54
10009120002,1701,1667,1654,1697,30
10009120003,2765,2750,2767,2743,-7
10009120004,2367,2380,2372,2355,-25
10009120005,2415,2381,2359,2377,-4
10009120006,1506,1501,1474,1442,-59
10009120007,2440,2393,2349,2322,-71
10009120008,956,951,930,916,-35
10009120009,1763,1716,1684,1654,-62
10009120010,2016,2011,1983,1966,-45
10009120011,1719,1683,1633,1595,-88
10009120012,1351,1316,1295,1263,-53
10009120013,1387,1363,1341,1326,-37
10009120014,918,910,885,859,-51
10009130001,5185,5159,5249,5344,185
10009130002,9132,9303,9550,9640,337
10009130003,2316,2343,2409,2414,71
10009130004,2987,3013,3101,3318,305
10009130005,3062,3083,3153,3228,145
10009130006,3550,3597,3649,3687,90
10009130007,2566,2591,2637,2647,56
10009130008,2389,2414,2472,2497,83
10009130009,4726,4775,4849,4887,112
10009130010,1323,1359,1363,1393,34
10009130011,4131,4227,4350,4405,178
10009130012,2537,2554,2588,2630,76
10009130013,1761,1778,1826,1861,83
10009140001,1735,1761,1698,1684,-77
10009140002,1391,1382,1375,1349,-33
10009140003,1880,1849,1830,1785,-64
10009140004,594,599,582,557,-42
10009140005,1342,1319,1299,1262,-57
10009140006,591,599,584,581,-18
10009140007,919,901,885,862,-39
10009140008,973,951,918,918,-33
10009140009,959,942,929,904,-38
10009140010,2174,2161,2101,2068,-93
10009140011,1219,1203,1144,1127,-76
10009140012,1116,1099,1071,1058,-41
10009150001,2209,2187,2181,2164,-23
10009150002,1745,1714,1662,1660,-54
10009150003,1786,1782,1751,1722,-60
10009150004,1310,1312,1298,1274,-38
10009150005,1757,1721,1690,1641,-80
10009150006,984,984,939,903,-81
10009150007,882,869,859,854,-15
10009150008,1361,1374,1351,1329,-45
10009150009,976,969,951,930,-39
10009160001,1414,1410,1405,1376,-34
10009160002,1245,1233,1212,1206,-27
10009160003,1266,1233,1252,1252,19
10009160004,2295,2323,2286,2255,-68
10009160005,1696,1660,1655,1641,-19
10009160006,2153,2129,2071,2051,-78
10009160007,691,693,680,675,-18
10009160008,778,769,741,732,-37
10009160009,504,494,486,486,-8
10009160010,955,946,929,929,-17
10009160011,1779,1722,1698,1681,-41
10009160012,1618,1621,1575,1542,-79
10009160013,3479,3446,3337,3283,-163
10009160014,1991,1995,1940,1894,-101
10009160015,2090,2056,2045,2009,-47
10009170001,3904,3874,3825,3818,-56
10009170002,1733,1714,1685,1643,-71
10009170003,1561,1521,1493,1468,-53
10009170004,802,803,784,756,-47
10009170005,1110,1105,1072,1056,-49
10009170006,1279,1235,1208,1190,-45
10009170007,1032,1022,985,967,-55
10009170008,838,826,802,779,-47
10009170009,655,651,646,656,5
10009170010,954,961,945,920,-41
10009170011,401,397,388,379,-18
10009170012,1326,1303,1270,1260,-43
10009170013,1715,1730,1672,1642,-88
10009170014,1152,1135,1104,1081,-54
10009170015,960,954,944,926,-28
10009170016,1363,1340,1309,1268,-72
10009170017,966,951,926,910,-41
10009170018,1752,1706,1695,1663,-43
10009170019,697,680,657,637,-43
10009170020,965,939,922,906,-33
10009170021,815,796,786,769,-27
10009180001,2036,1983,1956,1956,-27
10009180002,743,738,716,710,-28
10009180003,1078,1053,1003,981,-72
10009180004,1041,1013,1002,980,-33
10009180005,2680,2593,2579,2527,-66
10009180006,1370,1367,1343,1328,-39
10009180007,881,847,830,815,-32
10009180008,989,1002,959,922,-80
10009180009,989,966,929,915,-51
10009180010,404,398,388,388,-10
10009180011,885,862,825,810,-52
10009180012,1063,1027,1008,1001,-26
10009180013,1871,1865,1817,1792,-73
10009180014,870,849,855,840,-9
10009180015,790,772,769,742,-30
10009180016,1030,1020,989,968,-52
10009180017,1197,1174,1150,1135,-39
10009180018,1120,1099,1059,1050,-49
10009180019,808,801,816,813,12
10009180020,611,594,582,576,-18
10009180021,1211,1186,1174,1138,-48
10009190001,1420,1400,1401,1367,-33
10009190002,1283,1277,1263,1242,-35
10009190003,724,721,689,678,-43
10009190004,1004,1005,963,953,-52
10009190005,810,799,796,789,-10
10009190006,1164,1132,1123,1102,-30
10009190007,1650,1618,1599,1577,-41
10009190008,2331,2283,2259,2260,-23
10009190009,1793,1767,1722,1670,-97
10009190010,1709,1663,1644,1601,-62
10009190011,616,601,574,561,-40
10009190012,1731,1713,1712,1689,-24
10009190013,930,933,910,881,-52
10009190014,2245,2217,2177,2152,-65
10009190015,1068,1061,1029,1010,-51
10009190016,1153,1139,1124,1106,-33
10009190017,1100,1080,1058,1037,-43
10009190018,799,782,761,747,-35
10009190019,2065,2059,2050,2024,-35
10009190020,1384,1351,1321,1304,-47
10009190021,674,675,655,653,-22
10009200001,2630,2579,2525,2484,-95
10009200002,2309,2293,2270,2243,-50
10009200003,1157,1163,1143,1114,-49
10009200004,1363,1335,1312,1304,-31
10009200005,1054,1121,1058,1031,-90
10009200006,725,711,696,676,-35
10009200007,684,671,665,645,-26
10009200008,1156,1132,1100,1053,-79
10009200009,697,670,677,662,-8
10009200010,1088,1067,1040,1025,-42
10009200011,807,791,767,746,-45
10009200012,743,726,707,696,-30
10009200013,1233,1212,1155,1116,-96
10009200014,1118,1101,1099,1079,-22
10009200015,939,931,901,869,-62
10009200016,1100,1067,1055,1025,-42
10009200017,944,919,893,868,-51
10009200018,1366,1357,1346,1310,-47
10009200019,572,573,549,534,-39
10009200020,744,733,719,697,-36
10009200021,771,754,736,720,-34
10009200022,749,742,713,700,-42
10009200023,807,786,754,733,-53
10009200024,868,874,864,847,-27
10010010001,2714,2699,2704,2726,27
10010010002,570,569,549,535,-34
10010010003,1711,1702,1666,1670,-32
10010010004,1931,1962,1969,1980,18
10010010005,1317,1322,1299,1300,-22
10010010006,1196,1247,1255,1276,29
10010010007,942,953,943,921,-32
10010010008,2220,2222,2275,2313,91
10010010009,1453,1442,1428,1396,-46
10010010010,2781,2854,2859,2905,51
10010010011,831,811,814,805,-6
10010010012,614,623,611,603,-20
10010010013,3903,3997,4111,4182,185
10010010014,5495,5545,5576,5651,106
10010010015,2151,2158,2173,2134,-24
10010010016,3688,3693,3701,3717,24
10010010017,807,816,789,788,-28
10010010018,3457,3454,3579,3634,180
10010020001,2353,2355,2326,2316,-39
10010020002,2843,2833,2837,2844,11
10010020003,1316,1326,1307,1309,-17
10010020004,441,432,441,417,-15
10010020005,740,727,736,710,-17
10010020006,754,736,715,689,-47
10010020007,960,1050,1048,1047,-3
10010020008,2053,2031,1985,1952,-79
10010020009,3084,3048,3034,3018,-30
10010020010,5258,5212,5181,5228,16
10010020011,809,788,786,774,-14
10010020012,694,693,683,668,-25
10010020013,912,908,906,869,-39
10010020014,1224,1212,1189,1184,-28
10010020015,2230,2248,2226,2328,80
10010020016,3707,3690,3702,3691,1
10010020017,3908,3836,3859,3821,-15
10010020018,894,888,887,882,-6
10010020019,1254,1228,1222,1230,2
10010020020,1031,1022,989,973,-49
10010020021,279,283,279,276,-7
10010020022,802,796,788,787,-9
10010020023,874,865,860,843,-22
10010020024,814,807,802,786,-21
10010020025,1193,1192,1185,1170,-22
10010020026,1383,1346,1331,1314,-32
10010020027,572,560,551,543,-17
10010030001,695,693,683,674,-19
10010030002,420,412,403,384,-28
10010030003,2460,2471,2470,2459,-12
10010030004,1259,1246,1224,1209,-37
10010030005,1920,1886,1861,1811,-75
10010030006,1040,1012,973,974,-38
10010030007,831,812,788,775,-37
10010030008,879,859,842,824,-35
10010030009,1085,1086,1073,1063,-23
10010030010,1455,1448,1453,1438,-10
10010030011,2701,2650,2626,2592,-58
10010030012,1272,1275,1259,1251,-24
10010030013,1256,1244,1220,1194,-50
10010030014,2144,2109,2106,2070,-39
10010030015,329,315,302,294,-21
10010030016,440,459,440,423,-36
10010030017,316,311,300,295,-16
10010030018,848,832,815,794,-38
10010030019,1356,1320,1279,1261,-59
10010030020,1541,1496,1476,1463,-33
10010030021,1578,1543,1519,1493,-50
10010030022,584,575,559,563,-12
10010030023,734,719,710,686,-33
10010040001,572,565,558,538,-27
10010040002,2083,2073,2108,2095,22
10010040003,1127,1103,1084,1077,-26
10010040004,7014,6985,6934,6930,-55
10010040005,1357,1335,1323,1296,-39
10010040006,2033,2039,2070,2077,38
10010040007,677,657,649,645,-12
10010040008,803,795,793,766,-29
10010040009,715,695,675,672,-23
10010040010,207,209,199,195,-14
10010040011,1932,1880,1835,1801,-79
10010040012,1666,1642,1617,1577,-65
10010040013,1443,1430,1459,1451,21
10010040014,890,886,881,868,-18
10010040015,1785,1811,1771,1733,-78
10010040016,2328,2308,2308,2296,-12
10010040017,1084,1059,1038,1025,-34
10010040018,765,760,753,737,-23
10010040019,763,732,727,721,-11
10010040020,969,962,947,934,-28
10010040021,985,970,955,947,-23
10010050001,2713,2695,2707,2681,-14
10010050002,1906,1873,1836,1812,-61
10010050003,4052,4035,4050,4044,9
10010050004,2571,2549,2556,2541,-8
10010050005,1906,1861,1859,1861,0
10010050006,2138,2150,2148,2111,-39
10010050007,1692,1653,1651,1657,4
10010050008,2007,1978,1937,1927,-51
10010050009,1118,1116,1139,1132,16
10010050010,946,941,932,923,-18
10010050011,998,980,979,977,-3
10010050012,2481,2486,2487,2482,-4
10010050013,1550,1579,1585,1586,7
10010050014,592,586,593,583,-3
10010050015,1228,1209,1234,1305,96
10010050016,2199,2165,2144,2122,-43
10010050017,3135,3174,3196,3149,-25
10010050018,2229,2251,2240,2240,-11
10010050019,2823,2795,2770,2770,-25
10010050020,4277,4200,4154,4095,-105
10010050021,1515,1476,1472,1453,-23
10010050022,6228,6210,6212,6232,22
10010050023,2851,2834,2825,2848,14
10010050024,2683,2660,2653,2624,-36
10010050025,2848,2858,2864,2924,66
10010050026,1989,1999,1973,1957,-42
10010050027,3359,3340,3299,3295,-45
10010050028,7659,7714,7867,7986,272
10010060001,1523,1492,1462,1435,-57
10010060002,780,758,739,729,-29
10010060003,746,767,760,729,-38
10010060004,1149,1131,1105,1089,-42
10010060005,783,760,762,740,-20
10010060006,880,867,844,837,-30
10010060007,945,929,908,893,-36
10010060008,1282,1258,1230,1214,-44
10010060009,1122,1135,1088,1084,-51
10010060010,1063,1046,1033,1012,-34
10010060011,1462,1452,1417,1420,-32
10010060012,1205,1193,1183,1136,-57
10010060013,805,787,773,757,-30
10010060014,1006,1017,979,980,-37
10010070001,2616,2672,2637,2627,-45
10010070002,1825,1800,1785,1764,-36
10010070003,1731,1699,1686,1661,-38
10010070004,1887,1905,1918,1936,31
10010070005,1539,1534,1525,1557,23
10010070006,1739,1803,1791,1805,2
10010070007,1870,1845,1868,1834,-11
10010070008,1118,1101,1096,1084,-17
10010070009,646,640,633,623,-17
10010070010,1100,1062,1044,1013,-49
10010070011,578,564,544,529,-35
10010070012,558,546,546,539,-7
10010070013,1938,1896,1856,1847,-49
10010070014,1823,1812,1766,1736,-76
10010070015,1548,1530,1512,1477,-53
10010070016,1704,1706,1727,1741,35
10010070017,1220,1205,1158,1146,-59
10010070018,1120,1131,1111,1091,-40
10010070019,1182,1165,1146,1118,-47
10010070020,1339,1325,1304,1297,-28
10010070021,1215,1180,1186,1162,-18
10010070022,639,636,624,627,-9
10010070023,1000,966,957,948,-18
10010080001,1324,1307,1290,1275,-32
10010080002,926,911,891,875,-36
10010080003,990,952,952,927,-25
10010080004,240,228,219,211,-17
10010080005,1349,1369,1329,1299,-70
10010080006,1359,1341,1308,1300,-41
10010080007,976,980,977,958,-22
10010080008,731,705,678,678,-27
10010080009,829,829,817,793,-36
10010080010,804,785,764,738,-47
10010080011,1233,1209,1193,1175,-34
10010080012,1062,1049,1036,1009,-40
10010080013,1168,1153,1139,1122,-31
10010080014,1660,1632,1610,1585,-47
10010080015,696,679,660,650,-29
10010080016,529,519,509,510,-9
10010080017,680,672,656,653,-19
10010080018,1003,984,960,950,-34
10010080019,1506,1507,1483,1471,-36
10010080020,688,672,645,631,-41
10010080021,835,814,814,820,6
10010080022,624,608,589,579,-29
10010080023,728,693,681,670,-23
10010080024,754,727,721,704,-23
10010080025,624,635,619,613,-22
10010090001,2245,2210,2209,2165,-45
10010090002,1060,1046,1040,1045,-1
10010090003,1553,1535,1529,1491,-44
10010090004,1985,1961,1904,1870,-91
10010090005,1316,1290,1265,1256,-34
10010090006,813,802,775,767,-35
10010090007,428,423,420,418,-5
10010090008,961,945,938,922,-23
10010090009,1043,1020,992,971,-49
10010090010,844,830,804,789,-41
10010090011,414,421,405,385,-36
10010090012,1113,1094,1085,1061,-33
10010090013,1399,1389,1366,1353,-36
10010090014,966,931,933,907,-24
10010090015,786,764,732,713,-51
10010090016,957,941,930,907,-34
10010090017,780,755,739,727,-28
10010090018,1238,1228,1210,1191,-37
10010090019,1022,1009,1005,984,-25
10010090020,1383,1368,1353,1341,-27
10010090021,868,860,848,826,-34
10010090022,335,326,320,309,-17
10010090023,1460,1432,1392,1368,-64
10010100001,759,768,732,718,-50
10010100002,1709,1678,1656,1639,-39
10010100003,1332,1294,1268,1267,-27
10010100004,996,968,950,934,-34
10010100005,839,848,840,842,-6
10010100006,1369,1344,1328,1314,-30
10010100007,409,417,406,399,-18
10010100008,477,459,445,434,-25
10010100009,859,837,820,798,-39
10010100010,499,495,484,468,-27
10010100011,473,474,461,458,-16
10010100012,670,668,647,640,-28
10010100013,1678,1643,1637,1601,-42
10010100014,936,925,916,902,-23
10010100015,895,883,862,848,-35
10010100016,928,923,913,898,-25
10010100017,497,490,473,460,-30
10010100018,572,578,564,547,-31
10010100019,829,815,790,790,-25
10010100020,428,416,403,394,-22
10010100021,619,624,602,576,-48
10010100022,713,695,686,675,-20
10010110001,573,572,569,562,-10
10010110002,648,632,623,621,-11
10010110003,1442,1444,1420,1428,-16
10010110004,1512,1484,1493,1483,-1
10010110005,830,809,825,812,3
10010110006,1149,1121,1113,1095,-26
10010110007,488,480,477,462,-18
10010110008,923,899,888,881,-18
10010110009,1165,1168,1133,1100,-68
10010110010,1070,1049,1009,1006,-43
10010110011,1068,1050,1022,1017,-33
10010110012,1046,1031,1000,984,-47
10010110013,1362,1333,1294,1264,-69
10010110014,1651,1615,1607,1563,-52
10010110015,650,671,645,635,-36
10010120001,4614,4633,4674,4724,91
10010120002,2872,2857,2817,2805,-52
10010120003,1764,1777,1843,1848,71
10010120004,2440,2408,2377,2333,-75
10010120005,900,888,886,860,-28
10010120006,1843,1791,1792,1767,-24
10010120007,2078,2012,2012,2049,37
10010120008,2045,2039,2058,2044,5
10010120009,484,503,496,490,-13
10010120010,716,732,701,682,-50
10010120011,451,441,452,432,-9
10010120012,1545,1511,1513,1500,-11
10010120013,2247,2237,2213,2185,-52
10010120014,1191,1163,1139,1140,-23
10010120015,2294,2310,2292,2262,-48
10010120016,2241,2186,2192,2206,20
10010120017,2078,2087,2066,2078,-9
10010120018,4653,4681,4694,4709,28
10010120019,3242,3171,3160,3156,-15
10010120020,2239,2184,2156,2112,-72
10010120021,2034,1995,2001,2003,8
10010120022,1018,1039,1051,1030,-9
10010120023,1092,1089,1071,1064,-25
10010120024,1434,1389,1371,1365,-24
10010120025,1297,1288,1276,1295,7
10010120026,932,905,892,873,-32
10010130001,2143,2103,2086,2114,11
10010130002,1111,1089,1067,1044,-45
10010130003,953,943,923,895,-48
10010130004,996,984,965,966,-18
10010130005,1715,1661,1702,1703,42
10010130006,3236,3262,3284,3309,47
10010130007,3751,3763,3761,3797,34
10010130008,8035,7971,8004,7932,-39
10010130009,6494,6469,6421,6403,-66
10010130010,2180,2153,2115,2111,-42
10010130011,1719,1698,1697,1691,-7
10010130012,2449,2446,2415,2417,-29
10010130013,1181,1155,1143,1136,-19
10010130014,1365,1350,1324,1304,-46
10010130015,1109,1089,1059,1050,-39
10010130016,2248,2195,2161,2119,-76
10010130017,840,839,836,828,-11
10010130018,1159,1137,1127,1109,-28
10010130019,716,706,696,690,-16
10010130020,863,858,840,821,-37
10010130021,380,381,370,369,-12
10010130022,331,332,329,323,-9
10010140001,2956,2924,2882,2903,-21
10010140002,2587,2603,2571,2558,-45
10010140003,877,872,860,855,-17
10010140004,930,926,914,892,-34
10010140005,1405,1402,1374,1348,-54
10010140006,690,679,667,663,-16
10010140007,1216,1174,1171,1149,-25
10010140008,6009,5931,5905,5847,-84
10010140009,1633,1613,1602,1570,-43
10010140010,1647,1643,1605,1585,-58
10010140011,1839,1812,1803,1777,-35
10010140012,2053,2036,2000,1974,-62
10010140013,730,719,711,684,-35
10010140014,1187,1166,1156,1150,-16
10010140015,1004,996,973,937,-59
10010140016,711,710,720,702,-8
10010140017,2075,2048,2025,2018,-30
10010140018,745,727,720,708,-19
10010140019,485,485,460,457,-28
10010140020,2196,2177,2153,2127,-50
10010140021,1030,1006,1017,1012,6
10010140022,257,256,257,254,-2
10010140023,912,904,899,878,-26
10010140024,788,775,762,749,-26
10010150001,2613,2586,2525,2487,-99
10010150002,1032,1027,1007,995,-32
10010150003,581,590,590,578,-12
10010150004,5092,5112,5085,5038,-74
10010150005,457,450,444,439,-11
10010150006,616,602,578,569,-33
10010150007,425,398,379,376,-22
10010150008,697,695,676,653,-42
10010150009,1917,1889,1863,1841,-48
10010150010,657,641,627,610,-31
10010150011,944,930,897,885,-45
10010150012,558,547,538,527,-20
10010150013,316,313,300,293,-20
10010150014,471,471,456,447,-24
10010150015,850,829,829,814,-15
10010150016,720,702,690,675,-27
10010150017,1082,1066,1051,1037,-29
10010150018,447,434,428,423,-11
10010160001,1313,1289,1260,1274,-15
10010160002,476,479,466,468,-11
10010160003,1513,1494,1496,1462,-32
10010160004,2084,2064,2035,2017,-47
10010160005,959,949,938,937,-12
10010160006,1006,979,963,953,-26
10010160007,1472,1454,1426,1431,-23
10010160008,716,700,681,671,-29
10010160009,1083,1065,1066,1055,-10
10010160010,563,551,533,524,-27
10010160011,414,406,398,388,-18
10010170001,1697,1703,1692,1686,-17
10010170002,721,729,740,738,9
10010170003,511,508,503,495,-13
10010170004,1030,1032,1045,1032,0
10010170005,605,631,616,609,-22
10010180001,415,413,421,420,7
10010180002,218,212,191,193,-19
10010180003,169,161,153,150,-11
10010180004,354,344,346,349,5
10010180005,353,363,359,352,-11
10010180006,378,369,366,357,-12
10010180007,1000,992,989,982,-10
10010180008,1189,1186,1176,1174,-12
10010180009,284,288,281,288,0
10010180010,613,620,616,612,-8
10010180011,361,354,347,348,-6
10010180012,297,295,299,302,7
10013010001,841,860,877,876,16
10013010002,281,281,277,278,-3
10013010003,335,330,309,302,-28
10013010004,682,650,649,627,-23
10013010005,540,524,511,501,-23
10013010006,261,263,254,260,-3
10013010007,685,639,624,624,-15
10013010008,823,803,816,805,2
10013010009,663,651,640,652,1
10013010010,444,459,442,418,-41
10013010011,338,344,335,319,-25
10013010012,3073,3056,3029,2971,-85
10013010013,528,506,466,457,-49
10013010014,727,719,709,689,-30
10013010015,467,460,447,432,-28
10013010016,650,635,608,590,-45
10013010017,320,314,311,298,-16
10013010018,717,735,711,702,-33
10013010019,447,459,446,436,-23
10013010020,1818,1831,1808,1779,-52
10013010021,979,967,949,954,-13
10013010022,2419,2362,2320,2323,-39
10013010023,2926,2901,2906,2852,-49
10013010024,4510,4439,4389,4362,-77
10013010025,4938,4907,4884,4796,-111
10013010026,11121,11000,10969,10821,-179
10013010027,1762,1749,1756,1704,-45
10013010028,1224,1230,1215,1207,-23
10013010029,1292,1279,1257,1243,-36
10013010030,8520,8552,8563,8536,-16
10013010031,6327,6317,6329,6302,-15
10013010032,602,589,575,563,-26
10013010033,3355,3294,3305,3286,-8
10013010034,978,962,939,902,-60
10013010035,1086,1062,1057,1043,-19
10013010036,1417,1412,1398,1401,-11
10013010037,747,739,767,768,29
10013010038,1299,1293,1299,1297,4
10013010039,778,747,759,738,-9
10013010040,8288,8321,8293,8175,-146
10013010041,2987,3007,2931,2919,-88
10013010042,1735,1745,1706,1704,-41
10013010043,2683,2653,2645,2584,-69
10013010044,1763,1723,1700,1738,15
10013010045,1269,1264,1251,1234,-30
10013010046,2027,2019,1992,2012,-7
10013010047,456,439,421,390,-49
10013010048,342,307,282,269,-38
10013010049,2323,2315,2322,2309,-6
10013010050,1186,1175,1162,1143,-32
10013010051,1399,1373,1358,1344,-29
10013010053,9578,9544,9528,9522,-22
10013010054,3382,3364,3329,3320,-44
10013010055,4779,4710,4769,4815,105
10013010056,2301,2228,2216,2275,47
10013010057,370,374,372,377,3
10013010058,232,227,219,209,-18
10013010059,2056,2016,1960,1916,-100
10013010060,5864,5796,5755,5638,-158
10013010061,878,875,866,834,-41
10013010062,792,773,785,778,5
10013010063,769,757,746,723,-34
10013010064,5543,5561,5502,5518,-43
10013010065,6271,6308,6253,6195,-113
10013010066,2229,2228,2250,2222,-6
10013010067,2847,2784,2712,2663,-121
10013010068,2746,2766,2695,2666,-100
10013010069,7237,7264,7219,7238,-26
10013010070,2677,2649,2615,2559,-90
10013010071,2478,2476,2472,2444,-32
10013010073,14375,14476,14809,14896,420
10013010074,1917,1907,1923,1892,-15
10013010075,13616,13749,13897,13855,106
10013010076,1523,1520,1524,1499,-21
10013010077,991,995,973,980,-15
10013010078,1279,1258,1263,1251,-7
10013010079,1136,1125,1112,1111,-14
10013010080,1770,1744,1758,1783,39
10013010081,3438,3471,3500,3533,62
10013020001,572,568,561,561,-7
10013020002,671,648,638,630,-18
10013020003,1397,1389,1394,1385,-4
10013020004,1091,1091,1120,1109,18
10013020005,5701,5596,5562,5518,-78
10013020006,1043,1034,1003,991,-43
10013020007,6346,6274,6301,6437,163
10013020008,7599,7531,7479,7451,-80
10013020009,2492,2491,2490,2462,-29
10013020010,1677,1636,1616,1604,-32
10013020011,2660,2690,2703,2796,106
10013020012,2619,2632,2701,2733,101
10013020013,8371,8292,8355,8350,58
10013020014,1440,1405,1374,1353,-52
10013020015,1620,1622,1656,1655,33
10013020016,1034,1015,1007,1010,-5
10013020017,553,548,533,531,-17
10013020018,1836,1846,1838,1834,-12
10013020019,1900,1872,1853,1821,-51
10013020020,2003,1960,1915,1892,-68
10013020021,1752,1753,1732,1719,-34
10013030001,2426,2342,2305,2257,-85
10013030002,621,616,569,574,-42
10013030003,453,447,426,416,-31
10013030004,757,772,749,738,-34
10013030005,608,599,593,588,-11
10013030006,845,818,776,757,-61
10013030007,1972,1930,1849,1812,-118
10013030008,973,938,911,867,-71
10013030009,1490,1455,1406,1387,-68
10013030010,693,678,655,641,-37
10013030011,1667,1626,1614,1581,-45
10013030012,2271,2209,2163,2131,-78
10013030013,3444,3435,3426,3411,-24
10013030014,2169,2152,2102,2029,-123
10013030015,1907,1887,1834,1776,-111
10013030016,6686,6659,6739,6667,8
10013030017,2341,2302,2267,2230,-72
10013030018,1818,1799,1773,1736,-63
10013030019,10982,11221,11347,11554,333
10013030020,1611,1612,1605,1613,1
10013030021,1264,1267,1239,1223,-44
10013030022,868,849,813,743,-106
10013040001,1086,1090,1117,1070,-20
10013040002,2722,2761,2741,2687,-74
10013040003,1352,1364,1350,1349,-15
10013040004,5042,5027,5051,5047,20
10013040005,3688,3702,3729,3721,19
10013040006,1067,1061,1030,1014,-47
10013040007,604,610,607,583,-27
10013040008,532,543,543,534,-9
10013040009,1222,1214,1210,1202,-12
10013040010,1113,1121,1094,1101,-20
10013040011,1297,1300,1300,1291,-9
10013040012,1867,1897,1847,1835,-62
10013040013,2679,2697,2692,2678,-19
10013040014,1614,1628,1612,1589,-39
10013040015,2050,2041,2032,2038,-3
10013040016,1453,1433,1404,1408,-25
10013040017,1338,1329,1303,1267,-62
10013050001,714,697,681,679,-18
10013050002,1011,1009,1016,994,-15
10013050003,4064,3977,3929,3874,-103
10013050004,833,873,879,878,5
10013050005,1643,1600,1594,1617,17
10013050006,2664,2644,2637,2625,-19
10013050007,2430,2419,2443,2437,18
10013050008,1974,1926,1933,1905,-21
10013050009,2609,2592,2639,2641,49
10013050010,1157,1152,1139,1137,-15
10013050011,2186,2167,2157,2136,-31
10013050012,1829,1811,1830,1805,-6
10013050013,1674,1656,1661,1644,-12
10013050014,908,925,910,959,34
10013050015,1443,1458,1444,1413,-45
10013050016,1624,1670,1697,1731,61
10013050017,1107,1089,1090,1063,-26
10013050018,2301,2274,2292,2291,17
10013050019,1899,1890,1920,1883,-7
10013050020,1932,1933,1928,1938,5
10013050021,2025,2004,1999,1995,-9
10013050022,2426,2430,2416,2377,-53
10013050023,1767,1774,1763,1718,-56
10013050024,1240,1207,1170,1138,-69
10013050025,2349,2310,2299,2329,19
10013050026,1687,1649,1618,1607,-42
10013050027,1320,1330,1307,1291,-39
10013050028,994,949,948,949,0
10013050029,657,651,649,645,-6
10013050030,468,448,439,427,-21
10013060001,2982,2955,3002,2994,39
10013060002,4064,4011,4038,4052,41
10013060003,2288,2264,2211,2227,-37
10013060004,2969,2939,2935,2947,8
10013060005,1236,1200,1192,1174,-26
10013060006,980,980,965,955,-25
10013060007,1232,1207,1187,1164,-43
10013060008,1646,1637,1636,1640,3
10013060009,1878,1845,1803,1812,-33
10013060010,1354,1329,1300,1271,-58
10013060011,849,845,828,832,-13
10013060012,2778,2739,2714,2698,-41
10013060013,2034,2022,1989,1972,-50
10013060014,1628,1616,1634,1637,21
10013060015,1295,1292,1296,1273,-19
10013060016,795,796,806,822,26
10013070001,2387,2407,2370,2335,-72
10013070002,1076,1050,1018,1016,-34
10013070003,1728,1680,1682,1666,-14
10013070004,2877,2901,2877,2827,-74
10013070005,1318,1339,1311,1280,-59
10013070006,943,923,923,930,7
10013070007,747,736,725,716,-20
10013080001,1723,1701,1682,1645,-56
10013080002,1589,1587,1580,1600,13
10013080003,1936,1993,2001,1991,-2
10013080004,1488,1457,1400,1408,-49
10013080005,1333,1346,1315,1317,-29
10013080006,1866,1842,1829,1813,-29
10013080007,2088,2069,2054,2033,-36
10013080008,1430,1409,1413,1411,2
10013080009,1680,1693,1674,1665,-28
10013080010,5118,5123,5209,5254,131
10013080011,1859,1841,1832,1825,-16
10013090001,3739,3712,3745,3771,59
10013090002,1320,1298,1284,1267,-31
10013090003,1011,988,984,996,8
10013090004,1521,1516,1493,1540,24
10013090005,2462,2418,2382,2374,-44
10013090006,1732,1683,1704,1668,-15
10013090007,1820,1808,1792,1767,-41
10013090008,1893,1876,1870,1874,-2
10013090009,1860,1801,1764,1735,-66
10013090010,2855,2797,2750,2684,-113
10013090011,2337,2310,2287,2236,-74
10013090012,2207,2146,2107,2087,-59
10013090013,1130,1129,1129,1140,11
10013090014,572,562,562,568,6
10013100001,3716,3649,3591,3514,-135
10013100002,3281,3272,3230,3174,-98
10013100003,2180,2156,2083,2059,-97
10013100004,2780,2692,2682,2661,-31
10013100005,2000,1990,1956,1954,-36
10013100006,1212,1201,1205,1191,-10
10013100007,2119,2119,2080,2017,-102
10013100008,617,624,609,593,-31
10013100009,1044,1032,1005,994,-38
10013100010,1834,1824,1755,1740,-84
10013100011,4091,4056,4054,4025,-31
10013100012,1123,1104,1082,1077,-27
10013110001,2461,2451,2401,2389,-62
10013110002,1453,1415,1384,1382,-33
10013110003,838,822,812,803,-19
10013110004,672,654,642,624,-30
10013110005,1156,1147,1135,1137,-10
10013110006,1337,1324,1293,1292,-32
10013110007,648,647,653,653,6
10013110008,877,850,823,805,-45
10013110009,711,713,691,684,-29
10013110010,1377,1351,1354,1328,-23
10013110011,1637,1622,1609,1597,-25
10013110012,2116,2088,2098,2075,-13
10013110013,1415,1431,1397,1363,-68
10013110014,1179,1173,1161,1159,-14
10013110015,1279,1267,1242,1227,-40
10013110016,1152,1167,1140,1119,-48
10013110017,1225,1217,1214,1204,-13
10013110018,1383,1345,1298,1290,-55
10013110019,1706,1700,1659,1644,-56
10013120001,1393,1384,1389,1351,-33
10013120002,839,847,839,827,-20
10013120003,1988,1993,1983,1943,-50
10013120004,1037,1049,1044,1021,-28
10013120005,622,628,608,599,-29
10013120006,1222,1216,1210,1207,-9
10013120007,1207,1206,1187,1165,-41
10013120008,1623,1637,1606,1595,-42
10013120009,2369,2352,2321,2273,-79
10013120010,1926,1904,1926,1914,10
10013120011,1871,1900,1911,1907,7
10013120012,1648,1654,1619,1592,-62
10013120013,1471,1478,1488,1470,-8
10013120014,1340,1345,1342,1325,-20
10013130001,4617,4544,4545,4538,-6
10013130002,3582,3564,3550,3557,-7
10013130003,1484,1466,1452,1429,-37
10013130004,652,663,634,629,-34
10013130005,2509,2439,2438,2424,-15
10013130006,3153,3184,3202,3198,14
10013130007,5185,5071,5001,4971,-100
10013130008,3222,3228,3299,3450,222
10013130009,1881,1882,1839,1805,-77
10013130010,2142,2130,2067,2036,-94
10013130011,2070,2059,2000,2031,-28
10013130012,3296,3249,3215,3212,-37
10013130013,1062,1039,1018,1016,-23
10013130014,1254,1230,1219,1203,-27
10013130015,2731,2702,2660,2588,-114
10013130016,1813,1805,1780,1760,-45
10013130017,2845,2823,2796,2765,-58
10013130018,2856,2790,2774,2735,-55
10013130019,960,960,939,891,-69
10013130020,2026,1994,1953,1924,-70
10013130021,2872,2861,2793,2774,-87
10013130022,1538,1504,1490,1477,-27
10013130023,957,928,919,917,-11
10013140001,1685,1672,1624,1607,-65
10013140002,981,968,960,956,-12
10013140003,781,804,787,759,-45
10013140004,673,654,650,643,-11
10013140005,1473,1481,1469,1454,-27
10013140006,1125,1104,1100,1079,-25
10013140007,718,712,712,688,-24
10013140008,532,521,509,508,-13
10013140009,2812,2773,2745,2703,-70
10013140010,527,546,532,519,-27
10013140011,948,962,945,949,-13
10013140012,877,889,880,870,-19
10013140013,1266,1255,1238,1214,-41
10013140014,1383,1387,1363,1337,-50
10013140015,1377,1391,1349,1329,-62
10013150001,2229,2210,2174,2150,-60
10013150002,1163,1160,1137,1112,-48
10013150003,1054,1042,996,966,-76
10013150004,839,840,816,796,-44
10013150005,1926,1974,1928,1894,-80
10013150006,1240,1261,1237,1218,-43
10013150007,1485,1494,1449,1425,-69
10013160001,1382,1370,1345,1330,-40
10013160002,1012,1025,1017,989,-36
10013160003,1124,1099,1074,1065,-34
10013160004,699,702,686,668,-34
10013160005,1872,1854,1846,1818,-36
10013160006,4946,4853,4831,4815,-38
10013160007,2226,2205,2172,2118,-87
10013160008,1658,1638,1612,1586,-52
10013160009,2412,2373,2329,2315,-58
10013160010,810,807,785,769,-38
10013160011,998,1010,983,963,-47
10013160012,1066,1072,1065,1028,-44
10013160013,512,508,503,488,-20
10013160014,3147,3102,3075,3037,-65
10013160015,707,705,700,691,-14
10013170001,1935,1922,1931,1887,-35
10013170002,2919,2906,2865,2846,-60
10013170003,2499,2497,2497,2450,-47
10013170004,971,1000,966,952,-48
10013170005,946,964,944,924,-40
10013170006,2669,2639,2641,2604,-35
10013170007,2717,2651,2611,2559,-92
10013170008,1427,1388,1389,1382,-6
10013170009,2468,2428,2388,2354,-74
10013170010,1833,1771,1776,1737,-34
10013170011,1644,1605,1578,1534,-71
10013170012,2446,2385,2341,2296,-89
10013170013,3178,3148,3099,3057,-91
10013170014,4989,4977,4901,4838,-139
10013170015,2680,2599,2541,2519,-80
10013180001,3063,2995,3010,3024,29
10013180002,2633,2607,2600,2578,-29
10013180003,1616,1597,1602,1569,-28
10013180004,1669,1663,1652,1661,-2
10013180005,1289,1280,1279,1272,-8
10013180006,1901,1874,1837,1836,-38
10013180007,1189,1171,1154,1175,4
10013180008,2360,2332,2285,2263,-69
10013190001,1666,1647,1609,1611,-36
10013190002,1842,1795,1753,1727,-68
10013190003,1841,1844,1877,1838,-6
10013190004,804,796,792,780,-16
10013190005,3715,3647,3582,3525,-122
10013190006,2176,2115,2073,2038,-77
10013190007,1421,1421,1409,1393,-28
10013190008,1098,1090,1093,1077,-13
10013190009,2230,2188,2144,2075,-113
10013190010,1287,1252,1251,1211,-41
10013200001,1887,1898,1876,1863,-35
10013200002,1049,1061,1051,1024,-37
10013200003,523,517,524,544,27
10013200004,786,778,766,745,-33
10013200005,1204,1179,1153,1125,-54
10013200006,1113,1130,1104,1077,-53
10013200007,1163,1159,1154,1127,-32
10013200008,1219,1216,1220,1202,-14
10013200009,1121,1105,1088,1082,-23
10013200010,605,596,577,575,-21
10013210001,1619,1647,1644,1670,23
10013210002,1530,1484,1451,1434,-50
10013210003,912,872,846,824,-48
10013210004,1999,1980,1980,2005,25
10013210005,2225,2201,2167,2156,-45
10013210006,2443,2407,2384,2332,-75
10013210007,1084,1088,1065,1040,-48
10013210008,807,793,766,738,-55
10013210009,1333,1310,1287,1256,-54
10013210010,1254,1246,1228,1216,-30
10013210011,1284,1264,1251,1225,-39
10013210012,2890,2829,2777,2724,-105
10013220001,2441,2402,2402,2369,-33
10013220002,1413,1427,1411,1402,-25
10013220003,1114,1117,1101,1097,-20
10013220004,1901,1950,1931,1887,-63
10013220005,1333,1317,1296,1286,-31
10013220006,1259,1267,1257,1260,-7
10013220007,1912,1909,1875,1872,-37
10013220008,964,975,959,948,-27
10013230001,1627,1588,1563,1541,-47
10013230002,621,636,634,625,-11
10013230003,717,712,701,701,-11
10013230004,829,818,819,806,-12
10013230005,417,429,420,422,-7
10013230006,1017,1026,993,968,-58
10013230007,1362,1376,1335,1323,-53
10013230008,474,474,477,460,-14
10013230009,473,473,466,457,-16
10013230010,593,590,566,560,-30
10013230011,456,455,429,415,-40
10013240001,1702,1729,1643,1610,-119
10013240002,444,461,438,433,-28
10013240003,1430,1419,1382,1356,-63
10013240004,1430,1435,1374,1323,-112
10013240005,641,679,659,603,-76
10013240006,1484,1503,1479,1452,-51
10013240007,378,391,380,364,-27
10013240008,331,351,331,330,-21
10013250001,1134,1153,1117,1100,-53
10013250002,2207,2214,2164,2125,-89
10013250003,1144,1160,1126,1088,-72
10013250004,993,971,942,927,-44
10013260001,1690,1685,1686,1715,30
10013260002,399,401,405,411,10
10013260003,671,675,667,652,-23
10013260004,747,740,739,761,21
10013260005,893,891,889,886,-5
10013260006,691,704,692,688,-16
10013260007,398,415,411,407,-8
10013260008,568,586,591,594,8
10013260009,832,850,857,852,2
10013260010,755,750,736,723,-27
10013270001,1301,1331,1299,1272,-59
10013270002,344,329,326,317,-12
10013270003,198,213,202,205,-8
10013270004,466,526,516,511,-15
10013270005,432,421,405,411,-10
10013270006,505,534,547,531,-3
10013280001,525,543,524,521,-22
10013280002,983,996,974,965,-31
10013280003,1268,1270,1254,1257,-13
10013280004,1034,1088,1085,1070,-18
10013280005,533,549,538,540,-9
10013280006,2403,2383,2412,2415,32
10013290001,1032,1076,1060,1034,-42
10013290002,1141,1137,1138,1155,18
10013290003,739,747,756,752,5
10013290004,469,492,486,475,-17
10013290005,919,940,955,936,-4
10013290006,971,1000,1013,999,-1
10013300001,1097,1100,1105,1116,16
10013300002,693,688,687,695,7
10013300003,874,856,849,849,-7
10013300004,1304,1286,1280,1295,9
10013300005,1013,1024,1017,1006,-18
10013300006,1058,1056,1056,1049,-7
10013300007,1426,1423,1433,1438,15
10013310001,1170,1174,1186,1186,12
10013310002,818,818,825,832,14
10013310003,388,395,392,394,-1
10013310004,1118,1140,1143,1143,3
10013310005,783,790,796,795,5
10013310006,590,592,602,597,5
10013320001,849,869,864,848,-21
10013320002,899,920,926,912,-8
10013320003,759,816,781,732,-84
10013320004,246,264,249,252,-12
10013320005,343,361,339,320,-41
10013320006,583,594,603,606,12
10013320007,728,728,749,758,30
10013320008,399,402,401,411,9
10013330001,1910,1931,1904,1897,-34
10013330002,818,811,787,795,-16
10013330003,493,496,492,495,-1
10013330004,426,435,412,402,-33
10013330005,649,677,656,644,-33
10013330006,630,631,616,632,1
10014010001,1694,1683,1661,1648,-35
10014010002,992,973,995,1009,36
10014010003,2338,2412,2432,2452,40
10014010004,3010,3072,3071,3135,63
10014010005,3133,3168,3141,3163,-5
10014010006,3107,3067,3055,3085,18
10014010007,7642,7535,7492,7511,-24
10014010008,3533,3576,3527,3494,-82
10014010009,1038,1027,1006,970,-57
10014010010,3871,3772,3655,3577,-195
10014010011,4157,4080,4128,4157,77
10014010012,5306,5313,5352,5346,33
10014010013,2359,2352,2346,2277,-75
10014010014,742,780,795,746,-34
10014010015,1907,1896,1926,1876,-20
10014010016,711,721,701,703,-18
10014010017,1468,1439,1424,1365,-74
10014010018,1007,1026,991,953,-73
10014010019,807,792,788,781,-11
10014010020,877,877,851,828,-49
10014010021,888,877,850,870,-7
10014010022,912,902,885,894,-8
10014010023,1324,1380,1367,1419,39
10014010024,1019,997,989,980,-17
10014010025,698,674,667,654,-20
10014010026,1094,1052,1027,993,-59
10014010027,474,474,490,453,-21
10014010028,432,461,438,415,-46
10014010029,1876,1853,1867,1859,6
10014010030,2392,2416,2386,2488,72
10014010031,3387,3431,3494,3520,89
10014010032,3456,3388,3371,3357,-31
10014010033,1790,1778,1783,1778,0
10014010034,2601,2641,2674,2682,41
10014010035,1582,1574,1583,1573,-1
10014010036,3631,3592,3540,3487,-105
10014010037,1147,1141,1107,1076,-65
10014010038,9393,9368,9366,9353,-15
10014010039,5921,5891,5904,5822,-69
10014010040,2797,2740,2737,2731,-9
10014010041,1443,1430,1382,1385,-45
10014010042,1616,1596,1600,1584,-12
10014010043,1083,1043,1024,1024,-19
10014010044,1459,1468,1476,1449,-19
10014010045,1541,1557,1565,1564,7
10014010046,2305,2288,2293,2317,29
10014020001,683,678,648,639,-39
10014020002,1079,1071,1052,1034,-37
10014020003,1596,1577,1549,1499,-78
10014020004,3148,3089,3014,2977,-112
10014020005,2283,2236,2216,2163,-73
10014020006,2597,2564,2509,2455,-109
10014020007,831,820,788,784,-36
10014020008,2021,2024,1972,1954,-70
10014030001,1893,1894,1902,1871,-23
10014030002,1374,1367,1352,1355,-12
10014030003,1042,1045,1038,1029,-16
10014030004,979,968,935,901,-67
10014030005,2005,2001,1951,1897,-104
10014030006,624,615,600,595,-20
10014030007,825,813,797,772,-41
10014040001,558,552,542,531,-21
10014040002,493,485,484,495,10
10014040003,574,550,532,542,-8
10014040004,390,374,357,352,-22
10014040005,1322,1328,1303,1287,-41
10014040006,1465,1467,1439,1420,-47
10014040007,1184,1204,1203,1165,-39
10014040008,2581,2512,2518,2519,7
10014040009,1354,1345,1336,1338,-7
10014040010,3472,3467,3495,3494,27
10014040011,1295,1279,1285,1268,-11
10014040012,1393,1382,1363,1328,-54
10014040013,1318,1324,1275,1222,-102
10014100001,896,897,876,852,-45
10014100002,1328,1350,1315,1268,-82
10014100003,1570,1544,1507,1485,-59
10014100004,1679,1623,1547,1528,-95
10014100005,644,632,606,594,-38
10014090001,1498,1489,1479,1469,-20
10014090002,696,698,663,643,-55
10014090003,674,679,651,633,-46
10014090004,639,632,640,651,19
10014090005,1633,1614,1603,1576,-38
10014090006,2092,2071,2038,2029,-42
10014090007,899,898,888,900,2
10014090008,1975,2008,1973,1976,-32
10014090009,1057,1058,1049,1048,-10
10014070001,1737,1756,1716,1674,-82
10014070002,1337,1328,1307,1272,-56
10014070003,1106,1100,1085,1070,-30
10014070004,296,295,290,280,-15
10014070005,601,604,592,571,-33
10014070006,1045,1019,1002,997,-22
10014070007,2395,2377,2357,2339,-38
10014080001,697,694,651,642,-52
10014080002,1324,1307,1285,1290,-17
10014080003,626,622,608,611,-11
10014080004,2262,2235,2215,2175,-60
10014080005,1006,994,983,963,-31
10014080006,1345,1330,1279,1245,-85
10014050001,751,763,740,720,-43
10014050002,998,1008,989,962,-46
10014050003,1020,991,982,971,-20
10014050004,1667,1633,1615,1626,-7
10014050005,1009,1012,1010,983,-29
10014050006,1264,1256,1214,1181,-75
10014050007,1242,1212,1194,1158,-54
10014060001,1323,1308,1297,1270,-38
10014060002,733,720,730,740,20
10014060003,368,358,354,356,-2
10014060004,883,890,889,885,-5
10014060005,2257,2273,2271,2264,-9
10014060006,389,390,382,376,-14
10014060007,981,973,940,919,-54
10014060008,368,359,350,343,-16
10014060009,453,445,441,440,-5
10014060010,493,483,487,480,-3
10014110001,1088,1175,1140,1133,-42
10014110002,1205,1237,1200,1176,-61
10014110003,1633,1685,1705,1717,32
10014130001,725,736,707,723,-13
10014130002,379,391,380,379,-12
10014130003,514,517,508,510,-7
10014130004,708,724,703,693,-31
10014130005,1225,1260,1242,1244,-16
10014120001,987,975,965,958,-17
10014120002,338,328,318,313,-15
10014120003,336,337,326,317,-20
10014120004,1220,1216,1201,1186,-30
10014120005,715,709,709,719,10
10014120006,626,621,601,612,-9
10014150001,692,706,694,710,4
10014150002,981,1016,1015,995,-21
10014150003,375,384,374,376,-8
10014150004,695,675,650,635,-40
10014150005,441,476,448,419,-57
10014150006,334,323,318,354,31
10014140001,634,647,640,645,-2
10014140002,712,731,727,718,-13
10014140003,1510,1556,1532,1539,-17
10014140004,414,409,402,400,-9
10014140005,383,396,402,397,1
10014160001,1517,1550,1555,1595,45
10014160002,927,943,928,950,7
10014160003,1469,1467,1468,1499,32
10014160004,1162,1197,1176,1205,8
10015010001,1780,1863,1900,1941,78
10015010002,2253,2218,2240,2256,38
10015010003,610,574,592,550,-24
10015010004,715,728,775,821,93
10015010005,706,715,706,716,1
10015010006,3752,3750,3712,3617,-133
10015010007,2416,2341,2258,2245,-96
10015010008,4449,4428,4409,4345,-83
10015010009,1980,1970,1944,1886,-84
10015010010,2320,2275,2232,2242,-33
10015010011,62,,,,0
10015010012,562,553,526,536,-17
10015010013,738,698,701,679,-19
10015010014,4446,4439,4427,4429,-10
10015010015,1305,1238,1208,1169,-69
10015010016,5817,5779,5699,5570,-209
10015010017,4236,4241,4257,4194,-47
10015010018,4432,4385,4320,4287,-98
10015010019,1451,1400,1400,1396,-4
10015010020,827,779,763,743,-36
10015010021,2412,2383,2390,2374,-9
10015010022,1458,1460,1489,1489,29
10015010023,3095,3107,3098,3122,15
10015010024,2046,2084,2072,2089,5
10015010025,1063,1023,1041,1021,-2
10015010026,694,706,697,703,-3
10015010027,700,746,747,712,-34
10015010028,1071,1032,1031,993,-39
10015010029,3298,3334,3362,3319,-15
10015010030,606,617,618,621,4
10015010031,2523,2534,2438,2400,-134
10015010032,1253,1269,1278,1264,-5
10015010033,3447,3422,3478,3445,23
10015010034,779,787,806,771,-16
10015010035,506,544,541,538,-6
10015010036,1013,998,960,972,-26
10015010037,6528,6469,6437,6448,-21
10015010038,2967,2945,2923,2876,-69
10015010039,1057,1066,1018,1018,-48
10015010040,1707,1693,1682,1676,-17
10015010041,4932,4887,4875,4871,-16
10015010042,3113,3152,3147,3119,-33
10015010043,4370,4307,4281,4213,-94
10015010044,4748,4767,4812,4784,17
10015010045,4137,4135,4114,4079,-56
10015020001,1368,1342,1344,1358,16
10015020002,701,700,696,693,-7
10015020003,662,654,654,650,-4
10015020004,1322,1324,1326,1315,-9
10015020005,1491,1495,1493,1502,7
10015020006,541,555,561,565,10
10015020007,1423,1438,1445,1445,7
10015020008,620,616,605,618,2
10015020009,593,588,581,571,-17
10015020010,939,941,931,938,-3
10015020011,1100,1097,1072,1076,-21
10015020012,101,96,94,90,-6
10015030001,6241,6205,6200,6149,-56
10015030002,1980,1884,1870,1843,-41
10015030003,1501,1481,1446,1421,-60
10015030004,1593,1541,1511,1496,-45
10015030005,1429,1428,1384,1343,-85
10015030006,1435,1421,1390,1358,-63
10015030007,752,750,733,721,-29
10015030008,1126,1102,1082,1077,-25
10015030009,613,606,596,587,-19
10015030010,1785,1736,1698,1714,-22
10015030011,1744,1719,1674,1635,-84
10015030012,1008,998,985,984,-14
10015030013,865,884,864,847,-37
10015030014,995,997,984,987,-10
10015030015,1278,1255,1231,1219,-36
10015040001,1507,1486,1468,1437,-49
10015040002,1009,1020,1028,1004,-16
10015040003,2792,2793,2774,2771,-22
10015040004,4636,4686,4730,4764,78
10015040005,1137,1158,1153,1161,3
10015040006,4508,4517,4513,4541,24
10015040007,1576,1494,1434,1443,-51
10015040008,3020,3005,2983,2937,-68
10015050001,8811,8794,8966,8959,165
10015050002,5834,5797,5797,5745,-52
10015050003,4295,4287,4278,4274,-13
10015050004,4732,4661,4722,4768,107
10015050005,7756,7728,7769,7848,120
10015050006,5983,5996,6085,6053,57
10015050007,3386,3370,3378,3303,-67
10015050008,1776,1751,1746,1731,-20
10015050009,1425,1433,1419,1425,-8
10015050010,3354,3265,3269,3291,26
10015050011,3755,3700,3682,3662,-38
10015050012,4885,4906,4937,4954,48
10015050013,4780,4651,4631,4624,-27
10015050014,6890,6874,6890,6813,-61
10015050015,6222,6205,6184,6233,28
10015050016,2610,2637,2616,2591,-46
10015050017,5059,4962,5017,5026,64
10015050018,2194,2204,2197,2207,3
10015060001,392,388,381,386,-2
10015060002,1174,1176,1171,1168,-8
10015060003,2217,2165,2132,2133,-32
10015060004,1599,1574,1552,1500,-74
10015060005,1045,1023,1014,1006,-17
10015060006,782,789,801,826,37
10015060007,1893,1904,1894,1893,-11
10015060008,942,915,901,891,-24
10015060009,859,834,828,806,-28
10015060010,1594,1585,1601,1549,-36
10015060011,2924,2966,2969,2926,-40
10015060012,287,287,282,267,-20
10015060013,972,962,940,927,-35
10015060014,833,836,813,783,-53
10015060015,530,545,541,528,-17
10015070001,988,956,935,907,-49
10015070002,1442,1439,1434,1406,-33
10015070003,1082,1065,1039,1039,-26
10015070004,1165,1151,1134,1123,-28
10015070005,1210,1195,1191,1185,-10
10015070006,491,492,488,467,-25
10015070007,875,865,856,849,-16
10015070008,559,600,556,538,-62
10015070009,362,351,336,337,-14
10015070010,500,494,488,470,-24
10015070011,1152,1129,1106,1112,-17
10015070012,1068,1068,1038,1035,-33
10015070013,969,958,932,914,-44
10015070014,1025,1026,1003,987,-39
10015080001,1819,1944,1832,1797,-147
10015080002,652,710,671,664,-46
10015080003,409,505,447,432,-73
10015080004,784,828,803,784,-44
10015080005,719,765,723,699,-66
10015090001,2210,2158,2116,2091,-67
10015090002,2093,2113,2087,2102,-11
10015090003,605,617,597,589,-28
10015090004,1073,1103,1075,1038,-65
10015090005,689,690,676,665,-25
10015090006,1067,1073,1048,1035,-38
10015090007,996,986,974,982,-4
10015090008,391,396,385,384,-12
10015090009,855,871,860,845,-26
10015090010,987,980,960,948,-32
10015090011,687,681,655,633,-48
10015100001,528,522,520,521,-1
10015100002,1176,1139,1129,1105,-34
10015100003,748,736,738,716,-20
10015100004,644,642,640,631,-11
10015100005,1223,1225,1187,1179,-46
10015100006,498,497,490,486,-11
10015100007,1028,1022,1022,998,-24
10015100008,445,438,424,422,-16
10015100009,1573,1544,1521,1507,-37
10015100010,513,514,495,487,-27
10015100011,710,705,697,678,-27
10015100012,589,565,572,555,-10
10015100013,738,728,726,719,-9
10015110001,1748,1750,1763,1805,55
10015110002,2235,2255,2260,2248,-7
10015110003,2253,2241,2217,2261,20
10015110004,1506,1491,1533,1573,82
10015110005,1527,1538,1509,1493,-45
10015110006,1372,1390,1400,1404,14
10015110007,2208,2204,2197,2206,2
10015110008,1231,1232,1238,1251,19
10015110009,1809,1838,1836,1902,64
10015120001,1322,1314,1305,1288,-26
10015120002,659,695,668,650,-45
10015120003,965,966,955,951,-15
10015120004,813,815,800,776,-39
10015120005,1348,1353,1332,1328,-25
10015120006,1277,1276,1253,1244,-32
10015130001,684,677,675,685,8
10015130002,1190,1205,1167,1174,-31
10015130003,881,882,877,872,-10
10015130004,895,910,913,915,5
10015130005,1276,1283,1277,1287,4
10015130006,1140,1144,1126,1103,-41
10016010002,518,519,548,543,24
10016010003,639,630,635,625,-5
10016010004,597,588,597,591,3
10016010005,1052,1030,991,976,-54
10016010006,1154,1141,1118,1079,-62
10016010007,901,887,873,886,-1
10016010008,2261,2259,2221,2187,-72
10016010009,4763,4726,4734,4733,7
10016010010,1415,1364,1380,1362,-2
10016010011,6295,6213,6124,6085,-128
10016010012,2921,2903,2827,2798,-105
10016010013,1711,1709,1695,1705,-4
10016010014,6799,6912,7020,7090,178
10016010015,3814,3859,3895,4001,142
10016010016,4016,4019,4080,4113,94
10016010017,2028,2066,2074,2059,-7
10016010018,938,1091,1211,1217,126
10016010019,1102,1090,1111,1109,19
10016010020,3049,3077,3105,3144,67
10016010021,474,477,486,496,19
10016010022,2384,2419,2455,2470,51
10016010023,684,694,720,702,8
10016010024,1117,1153,1178,1186,33
10016010025,1211,1233,1318,1394,161
10016010026,656,679,705,721,42
10016010027,1962,1955,1921,1920,-35
10016010028,2811,2857,2863,2898,41
10016010029,391,405,477,482,77
10016010030,443,439,431,431,-8
10016010031,1346,1353,1356,1326,-27
10016010032,1610,1627,1618,1607,-20
10016010033,869,858,849,874,16
10016010034,377,378,383,396,18
10016020001,1286,1296,1336,1361,65
10016020002,380,378,390,395,17
10016020003,269,267,257,262,-5
10016020004,326,327,326,335,8
10016020005,765,759,774,780,21
10016020006,358,376,382,375,-1
10016020007,830,832,854,842,10
10016020008,717,741,858,921,180
10016020009,823,837,890,949,112
10016020010,143,142,122,122,-20
10016020011,246,249,239,239,-10
10016020012,324,334,330,326,-8
10016020013,732,716,730,706,-10
10016020014,339,343,382,412,69
10016020015,901,889,884,882,-7
10016020016,294,291,344,369,78
10016020017,102,99,97,98,-1
10016020018,925,957,1010,1047,90
10016020019,1163,1158,1173,1172,14
10016020020,752,758,780,783,25
10016020021,2021,2030,2015,2019,-11
10016020022,812,815,824,835,20
10016030001,615,621,621,615,-6
10016030002,757,738,753,765,27
10016030003,123,122,120,120,-2
10016030004,174,171,165,165,-6
10016030005,329,324,322,320,-4
10016030006,241,244,230,227,-17
10016030007,192,187,193,195,8
10016030008,1974,1984,1979,1991,7
10016030009,311,312,325,332,20
10016030010,800,802,801,816,14
10016030011,876,871,880,883,12
10016030012,1597,1619,1607,1610,-9
10016030013,1257,1266,1283,1295,29
10016030014,277,279,272,289,10
10016030015,294,287,282,284,-3
10016040001,348,338,336,341,3
10016040002,485,467,463,467,0
10016040003,327,323,325,317,-6
10016040004,929,918,908,907,-11
10016040005,751,739,736,738,-1
10016040006,167,156,155,149,-7
10016040007,706,708,706,712,4
10016040008,235,231,231,231,0
10016040009,630,649,646,643,-6
10016040010,1450,1435,1420,1452,17
10016040011,2380,2385,2380,2396,11
10016050001,815,803,795,807,4
10016050002,497,501,490,495,-6
10016050003,317,320,325,352,32
10016050004,480,499,507,522,23
10016050005,1599,1612,1624,1636,24
10016050006,617,616,617,640,24
10016050007,251,251,264,259,8
10016050008,260,272,278,289,17
10016050009,340,361,373,371,10
10016060001,271,264,269,278,14
10016060002,660,659,660,677,18
10016060003,729,725,735,748,23
10016060004,410,409,403,409,0
10016060005,394,380,389,412,32
10016060006,1392,1388,1343,1361,-27
10017010001,795,787,774,769,-18
10017010002,1355,1329,1323,1309,-20
10017010003,1020,1001,973,955,-46
10017010004,1194,1154,1152,1130,-24
10017010005,1372,1341,1308,1328,-13
10017010006,1374,1341,1303,1282,-59
10017010007,1408,1413,1398,1360,-53
10017010008,952,903,858,833,-70
10017010009,1325,1723,1732,1716,-7
10017010010,2584,2574,2554,2522,-52
10017010011,1468,1477,1458,1460,-17
10017010012,2283,2220,2190,2206,-14
10017010013,2230,2218,2198,2218,0
10017010014,1423,1410,1417,1383,-27
10017010015,1360,1309,1294,1275,-34
10017010016,2028,2010,1975,1925,-85
10017010017,1147,1143,1128,1073,-70
10017010018,1461,1416,1392,1356,-60
10017010019,1687,1651,1622,1622,-29
10017010020,1451,1417,1400,1348,-69
10017010021,551,512,497,508,-4
10017010022,6093,6155,6347,6427,272
10017010023,2285,1853,1819,1797,-56
10017010024,1078,1051,1025,979,-72
10017010025,6404,6428,6496,6574,146
10017010026,5835,5834,5850,5869,35
10017020001,4350,4329,4290,4280,-49
10017020002,2915,2903,2937,2939,36
10017020003,4181,4118,4055,4047,-71
10017020004,2229,2205,2191,2167,-38
10017020005,2555,2544,2527,2533,-11
10017020006,1795,1766,1739,1716,-50
10017020007,1236,1272,1328,1365,93
10017020008,2575,2569,2594,2555,-14
10017020009,4952,4953,4944,4951,-2
10017020010,4186,4124,4252,4266,142
10017020011,2440,2419,2359,2361,-58
10017020012,488,487,477,452,-35
10017020013,316,349,345,334,-15
10017020014,382,381,368,354,-27
10017020015,2021,2040,2079,2126,86
10017020016,487,493,494,489,-4
10017020017,2303,2277,2258,2236,-41
10017020018,7193,7232,7177,7160,-72
10017020019,4478,4466,4446,4417,-49
10017020020,2890,2855,2872,2867,12
10017030001,1677,1640,1614,1583,-57
10017030002,741,708,717,709,1
10017030003,808,824,832,822,-2
10017030004,4206,4206,4214,4164,-42
10017030005,3118,3103,3118,3127,24
10017030006,3395,3349,3310,3341,-8
10017030007,2904,2890,2892,2873,-17
10017030008,3039,3047,3024,2976,-71
10017030009,475,475,461,457,-18
10017030010,5373,5390,5423,5495,105
10017030011,510,515,505,474,-41
10017030012,5767,5707,5614,5626,-81
10017030013,6695,6765,6811,6901,136
10017040001,2403,2366,2343,2281,-85
10017040002,1476,1481,1467,1450,-31
10017040003,2229,2143,2138,2071,-72
10017040004,2471,2437,2458,2494,57
10017040005,3328,3295,3251,3202,-93
10017040006,2460,2391,2399,2416,25
10017040007,1191,1150,1176,1179,29
10017040008,1339,1282,1283,1302,20
10017040009,1042,1024,1017,1019,-5
10017040010,1714,1701,1655,1640,-61
10017040011,844,804,809,791,-13
10017040012,1077,1060,1031,1021,-39
10017040013,2873,2859,2806,2783,-76
10017040014,861,867,840,799,-68
10017040015,1442,1439,1389,1370,-69
10017040016,845,851,833,838,-13
10017040017,1941,1939,1942,1906,-33
10017040018,926,911,884,870,-41
10017040019,927,944,920,917,-27
10017040020,934,920,895,882,-38
10017040021,808,812,780,771,-41
10017040022,1111,1112,1084,1060,-52
10017040023,1239,1206,1192,1190,-16
10017040024,3162,3132,3065,3039,-93
10017040025,755,755,747,733,-22
10017040026,613,598,593,593,-5
10017040027,825,795,786,758,-37
10017040028,649,649,652,652,3
10017040029,2829,2807,2766,2760,-47
10017050001,877,859,863,852,-7
10017050002,1139,1132,1121,1124,-8
10017050003,853,833,828,835,2
10017050004,1057,1063,1064,1079,16
10017050005,861,858,841,808,-50
10017050006,1432,1426,1415,1383,-43
10017050007,872,862,847,834,-28
10017050008,1314,1288,1274,1252,-36
10017050009,1112,1093,1086,1073,-20
10017050010,1491,1475,1451,1403,-72
10017050011,2027,1986,1936,1899,-87
10017050012,1783,1773,1747,1699,-74
10017050013,1490,1482,1422,1414,-68
10017050014,688,665,654,641,-24
10017050015,992,989,969,948,-41
10017050016,780,768,751,722,-46
10017050017,972,946,941,930,-16
10017050018,1038,1051,1029,1033,-18
10017050019,1843,1802,1779,1757,-45
10017050020,6259,6161,6082,6008,-153
10017050021,6458,6415,6380,6333,-82
10017050022,4387,4333,4344,4400,67
10017050023,495,503,487,473,-30
10017050024,7688,7635,7586,7559,-76
10017060001,1369,1352,1329,1307,-45
10017060002,1196,1146,1150,1151,5
10017060003,1558,1524,1518,1508,-16
10017060004,1172,1151,1106,1114,-37
10017060005,1060,1038,1037,1010,-28
10017060006,2327,2347,2302,2272,-75
10017060007,2241,2227,2185,2160,-67
10017060008,3619,3609,3545,3501,-108
10017060009,950,966,962,950,-16
10017060010,650,639,630,605,-34
10017060011,4594,4596,4564,4540,-56
10017060012,1866,1902,1912,1926,24
10017060013,6088,6092,6109,6128,36
10017060014,4655,4710,4718,4744,34
10017060015,3013,2994,2936,2867,-127
10017060016,5763,5685,5602,5540,-145
10017060017,4010,3993,3930,3897,-96
10017060018,4527,4507,4521,4462,-45
10017060019,3084,3013,2930,2856,-157
10017060020,3435,3393,3387,3274,-119
10017060021,5416,5413,5620,5673,260
10017060022,3847,3837,3809,3745,-92
10017060023,5466,5480,5497,5478,-2
10017060024,5155,5407,5685,5803,396
10017060025,5297,5273,5283,5265,-8
10017070001,1383,1326,1280,1239,-87
10017070002,1369,1351,1332,1298,-53
10017070003,1360,1336,1331,1406,70
10017070004,2544,2562,2519,2481,-81
10017070005,788,790,772,776,-14
10017070006,1682,1667,1617,1651,-16
10017070007,812,816,785,772,-44
10017070008,1750,1696,1666,1641,-55
10017070009,1810,1775,1769,1720,-55
10017070010,1698,1670,1621,1602,-68
10017070011,2448,2383,2326,2290,-93
10017070012,1960,1925,1916,1938,13
10017070013,4033,3936,3894,3896,-40
10017070014,3131,3096,3037,2983,-113
10017070015,1539,1538,1545,1551,13
10017070016,4689,4695,4729,4605,-90
10017070017,3947,4474,4818,5172,698
10017070018,3984,3964,3971,4023,59
10017070019,2953,2905,2857,2968,63
10017070020,8155,8757,8993,9156,399
10018010001,777,786,787,771,-15
10018010002,1589,1612,1624,1640,28
10018010003,1004,970,973,970,0
10018010004,556,562,539,534,-28
10018010005,660,642,632,624,-18
10018010006,358,342,333,322,-20
10018010007,763,754,722,694,-60
10018010008,568,543,524,509,-34
10018010009,885,870,854,822,-48
10018010010,825,824,822,833,9
10018010011,1832,1829,1912,1961,132
10018010012,750,729,733,727,-2
10018010013,4237,4247,4237,4208,-39
10018010014,3461,3404,3301,3249,-155
10018010015,1681,1673,1660,1599,-74
10018010016,6567,6532,6473,6380,-152
10018010017,2286,2290,2304,2382,92
10018010018,5841,5819,5856,5914,95
10018010019,5559,5499,5470,5473,-26
10018010020,6139,6105,6021,5967,-138
10018010021,7720,8055,8482,8704,649
10018010022,3327,3334,3352,3697,363
10018010023,3327,3444,3548,3746,302
10018010024,5868,5925,5952,6026,101
10018010025,5255,5217,5282,5264,47
10018010026,8927,8909,8923,8966,57
10018010027,4381,4391,4360,4303,-88
10018010028,4141,4208,4184,4235,27
10018010029,3515,3557,3495,3450,-107
10018010030,6076,6169,6198,6178,9
10018010031,6915,6901,6851,6765,-136
10018010032,1516,1517,1527,1515,-2
10018010033,3949,3932,3878,3761,-171
10018010035,1159,1122,1112,1100,-22
10018010036,3616,3575,3564,3499,-76
10018010037,3999,4435,4512,4760,325
10018010038,3559,3566,3539,3513,-53
10018010039,3991,3943,3940,3931,-12
10018010040,2573,2545,2589,2551,6
10018010041,6034,6502,7058,7774,1272
10018010042,10486,11914,12838,13686,1772
10018010043,6927,6984,7043,7056,72
10018010044,5851,5870,5883,5877,7
10018010045,6396,6416,6364,6309,-107
10018010046,6081,6078,6144,6250,172
10018010047,8902,8828,8804,8742,-86
10018010048,3046,3090,3139,3070,-20
10018010049,4084,4053,4039,4036,-17
10018010050,6695,6703,6809,6859,156
10018010051,2358,2392,2414,2504,112
10018010052,4245,4240,4183,4104,-136
10018010053,5992,6152,6189,6194,42
10018010054,5304,5567,5869,6052,485
10018020001,616,631,641,648,17
10018020002,832,822,813,820,-2
10018020003,858,843,831,832,-11
10018020004,542,538,535,516,-22
10018020005,1291,1267,1253,1205,-62
10018020006,613,606,592,601,-5
10018020007,1763,1746,1718,1685,-61
10018020008,1131,1181,1179,1152,-29
10018020009,635,696,897,992,296
10018020010,974,947,973,982,35
10018020011,935,973,989,994,21
10018020012,1798,1840,1802,1720,-120
10018020013,1915,1909,1920,1930,21
10018020014,6316,6394,6425,6401,7
10018020015,3500,3532,3494,3538,6
10018020016,4776,4780,4823,4843,63
10018020017,2560,2548,2516,2488,-60
10018020018,1962,1964,2060,2172,208
10018020019,4677,4673,4663,4582,-91
10018020020,1050,1020,1003,975,-45
10018020021,3356,3344,3343,3311,-33
10018020022,7317,7369,7291,7244,-125
10018020023,5491,5480,5475,5413,-67
10018020024,6844,6813,6780,6786,-27
10018020025,662,677,670,661,-16
10018020026,3252,3307,3356,3398,91
10018020027,1902,1917,2039,2134,217
10018020028,3993,4127,4175,4236,109
10018020029,4301,4562,4780,4978,416
10018020030,2246,2250,2243,2069,-181
10018020031,4797,4740,4596,4511,-229
10018020032,6113,6088,6028,6046,-42
10018020033,3407,3396,3332,3297,-99
10018020034,4941,5033,5104,5064,31
10018020035,314,316,279,259,-57
10018020036,5774,5835,5847,5764,-71
10018020037,7056,7083,7124,7042,-41
10018020038,6071,6070,6016,5903,-167
10018020039,4788,4786,4794,4851,65
10018020040,5855,5809,5842,5881,72
10018020041,7176,7296,7334,7267,-29
10018020042,8050,8098,8120,8069,-29
10018020043,2610,2544,2655,3264,720
10018020044,1807,1871,1877,1868,-3
10018020045,3769,3958,4124,4220,262
10018030001,2999,2991,3043,3099,108
10018030002,6317,6279,6332,6393,114
10018030003,2772,2761,2719,2672,-89
10018030004,2870,2900,2879,2879,-21
10018030005,2527,2495,2477,2446,-49
10018030006,4103,3867,3907,3881,14
10018030007,3412,3453,3455,3411,-42
10018030008,5094,5380,5414,5413,33
10018030009,6173,6139,6082,6060,-79
10018030010,4738,4777,4794,4837,60
10018030011,3893,4056,4171,4225,169
10018030012,5247,5298,5303,5337,39
10018030013,3376,3373,3405,3444,71
10018030014,1305,1303,1272,1265,-38
10018030015,2423,2475,2488,2497,22
10018030016,2729,2780,2803,2761,-19
10018030017,1047,1045,1068,1057,12
10018030018,1010,1025,1015,999,-26
10018030019,965,953,960,962,9
10018030020,2095,2141,2095,2108,-33
10018030021,5260,5246,5247,5211,-35
10018030022,1655,1640,1659,1685,45
10018030023,978,972,942,928,-44
10018030024,4955,5041,5081,5174,133
10020010001,5624,5685,5784,5742,57
10020010002,4251,4185,4129,4140,-45
10020010003,3559,3532,3523,3456,-76
10020010004,3931,3903,3866,3825,-78
10020010005,2647,2630,2618,2591,-39
10020010034,5005,4956,5002,4974,18
10020010035,5008,4950,4896,4846,-104
10020010036,4784,4736,4691,4619,-117
10020010037,2711,2678,2620,2611,-67
10020010038,2147,2121,2103,2080,-41
10020010039,5339,5284,5259,5168,-116
10020010041,2220,2262,2303,2321,59
10020010042,1254,1244,1233,1219,-25
10020010043,3485,3456,3470,3441,-15
10020010044,2633,2691,2714,2731,40
10020010045,2356,2324,2319,2282,-42
10020010046,1600,1566,1515,1470,-96
10020010047,1911,1861,1866,1830,-31
10020010048,1561,1504,1496,1461,-43
10020010049,4210,4160,4149,4072,-88
10020010050,2511,2507,2506,2486,-21
10020010051,2968,2990,3010,2989,-1
10020010052,3178,3191,3215,3157,-34
10020010053,2815,2807,3190,3371,564
10020010054,4696,4699,4615,4586,-113
10020010055,4474,4405,4362,4283,-122
10020010056,2563,2532,2488,2415,-117
10020010057,2155,2094,2032,1962,-132
10020010058,2354,2323,2254,2198,-125
10020010059,2365,2300,2244,2218,-82
10020010060,2156,2122,2110,2062,-60
10020010061,2224,2221,2215,2207,-14
10020010062,2622,2601,2526,2547,-54
10020010063,3344,3305,3293,3251,-54
10020010064,2608,2639,2547,2521,-118
10020010065,2612,2556,2549,2539,-17
10020010066,4564,4556,4612,4572,16
10020010067,2248,2211,2176,2171,-40
10020010068,3410,3375,3325,3301,-74
10020020001,936,942,967,1006,64
10020020002,2542,2528,2480,2446,-82
10020020003,2741,2713,2693,2662,-51
10020020005,2419,2407,2356,2364,-43
10020020009,5002,5161,5271,5267,106
10020020010,5159,5163,5144,5133,-30
10020020011,3861,3859,3871,3866,7
10020020012,3444,3527,3522,3530,3
10020020013,1837,1818,1824,1820,2
10020020014,1316,1321,1309,1287,-34
10020020015,2482,2530,2515,2530,0
10020020016,4894,4851,4878,4807,-44
10020020017,3891,3953,3909,3957,4
10020020018,4253,4256,4282,4257,1
10020020019,4130,4154,4121,4103,-51
10020020020,2145,2196,2207,2191,-5
10020020021,8069,8156,8179,8210,54
10020020022,2542,2477,2455,2422,-55
10020020031,2278,2277,2217,2172,-105
10020020045,1983,1967,1974,1956,-11
10020020046,2345,2316,2321,2278,-38
10020020047,7301,7346,7400,7371,25
10020020048,6994,7037,7065,7086,49
10020020049,5492,5446,5351,5508,62
10020020050,4431,4471,4406,4326,-145
10020020051,2158,2162,2137,2075,-87
10020020052,2160,2143,2154,2161,18
10020020053,6299,6318,6306,6422,104
10020020054,1675,1719,1671,1688,-31
10020020055,2019,1980,1966,2003,23
10020020056,2295,2303,2261,2207,-96
10020020057,1953,1930,1921,1886,-44
10020020058,2526,2516,2493,2477,-39
10020020059,2640,2612,2580,2571,-41
10020020060,1572,1550,1473,1441,-109
10020020061,1621,1611,1572,1544,-67
10020020062,1883,1855,1788,1722,-133
10020020063,1928,1903,1880,1805,-98
10020020064,2569,2554,2490,2408,-146
10020020065,5147,5097,5116,5058,-39
10020020066,3446,3398,3421,3357,-41
10020020067,2098,2081,2088,2065,-16
10020020068,4427,4388,4386,4370,-18
10020020069,5045,5145,5097,5100,-45
10020020070,1347,1323,1348,1375,52
09020010001,5755,5802,5718,5624,-178
09020010002,11572,11501,11356,11257,-244
09020010003,6312,6302,6237,6144,-158
09020010004,4806,4698,4655,4554,-144
09020010005,4240,4315,4404,4513,198
09020010006,2281,2348,2413,2408,60
09020010007,3186,3164,3159,3184,20
09020010008,5133,5195,5311,5316,121
09020030001,4824,4765,4655,4573,-192
09020030002,3796,3802,3808,3808,6
09020030003,2864,2941,2961,2971,30
09020030004,2199,2232,2288,2314,82
09020030005,3600,3626,3605,3714,88
09020030006,8614,8995,9309,9392,397
09020030007,1697,1680,1688,1748,68
09020030008,1819,1815,1857,1880,65
09020020001,5794,5841,5807,5751,-90
09020020002,2045,2062,2106,2084,22
09020020003,1262,1266,1268,1266,0
09020020004,2605,2636,2600,2607,-29
09020020005,2196,2227,2227,2225,-2
09020020006,1657,1696,1722,1732,36
09020020007,2369,2402,2408,2413,11
09020020008,2607,2654,2664,2654,0
09020040001,3582,3627,3628,3668,41
09020040002,4925,5140,5357,5541,401
09020040003,1688,1743,1785,1812,69
09020040004,8033,8254,8479,8682,428
09020040005,5715,5856,5896,5935,79
09020040006,6895,7145,7386,7432,287
09020050001,3123,3125,3084,3089,-36
09020050002,1537,1573,1546,1545,-28
09020050003,2595,2636,2631,2622,-14
09020050004,3726,3741,3705,3686,-55
09020050005,1719,1786,1783,1791,5
09020060001,313,317,314,306,-11
09020060002,372,365,365,356,-9
09007010001,2358,2373,2380,2401,28
09007010002,1255,1217,1186,1146,-71
09007010003,913,926,885,878,-48
09007010004,1051,1133,1161,1175,42
09007010005,556,565,574,581,16
09007010006,425,435,443,459,24
09007010007,597,607,571,569,-38
09007010008,226,240,240,268,28
09007010009,163,167,159,161,-6
09007020001,1108,1140,1220,1215,75
09007020002,191,205,212,233,28
09007020003,375,391,411,409,18
09007020004,205,217,221,302,85
09007020005,336,321,385,405,84
09007020006,145,151,146,153,2
09007030001,480,479,449,442,-37
09007030002,215,214,214,212,-2
09007030003,78,72,67,67,-5
09007030004,283,277,271,248,-29
09007030005,568,576,542,520,-56
09007040001,657,648,642,642,-6
09007040002,695,702,710,793,91
68000010077,,4896,4951,4930,34
68000010078,,6255,6280,6257,2
68000010079,,5715,5703,5959,244
68000030028,,4022,4017,4014,-8
68000050039,,5548,5599,5621,73
68000050040,,3030,3031,3017,-13
68000070031,,7824,8482,8966,1142
68000070032,,3878,3952,4001,123
68000090032,,1711,1806,1908,197
67000010030,,3128,3054,2975,-153
67000020026,,1673,1650,1615,-58
67000020027,,1817,1813,1789,-28
67000020028,,1764,1724,1707,-57
67000020029,,1798,1778,1737,-61
67000020030,,1151,1134,1099,-52
67000020031,,1231,1216,1184,-47
67000020032,,996,976,965,-31
67000020033,,1570,1537,1508,-62
67000030025,,2282,2236,2188,-94
67000030026,,1671,1646,1624,-47
67000030027,,1544,1497,1462,-82
67000050022,,2246,2210,2205,-41
67000050023,,2542,2497,2467,-75
67000050024,,1343,1336,1303,-40
67000070030,,2234,2181,2178,-56
67000070031,,1907,1891,1853,-54
67000070032,,2009,1958,1924,-85
67000070033,,1589,1653,1668,79
67000080016,,2530,2486,2444,-86
67000080017,,1764,1769,1763,-1
67000080018,,2553,2532,2499,-54
67000100014,,1357,1347,1318,-39
67000100015,,2871,2792,2768,-103
67000100016,,2126,2081,2031,-95
67000120022,,1165,1158,1136,-29
67000120023,,6350,6348,6298,-52
67000120024,,2370,2323,2298,-72
67000120025,,2063,2030,1970,-93
67000120026,,3076,3036,3012,-64
67000120027,,5406,5488,5511,105
67000160019,,1360,1308,1291,-69
67000160020,,2650,2677,2652,2
67000160021,,2784,2747,2692,-92
67000160022,,2227,2184,2168,-59
67000160023,,1781,1736,1680,-101
67000170014,,1660,1608,1567,-93
67000170015,,1400,1381,1346,-54
67000190022,,1352,1326,1336,-16
67000190023,,2264,2258,2227,-37
67000190024,,3365,3966,4673,1308
67000210017,,1827,1830,1862,35
67000210018,,2691,2686,2682,-9
67000270019,,2607,2534,2513,-94
67000290018,,4025,3952,3917,-108
67000290019,,1711,1684,1661,-50
67000310040,,6243,6261,6286,43
67000310041,,4651,4733,4918,267
67000310042,,5483,5450,5476,-7
67000310043,,4444,4456,4540,96
67000330040,,4252,4191,4114,-138
67000340044,,4487,4381,4267,-220
67000340045,,3985,3886,3793,-192
67000340046,,6115,6047,5875,-240
67000340047,,4526,4467,4421,-105
67000340048,,5545,5510,5415,-130
67000340049,,3479,3404,3318,-161
67000340050,,3255,3218,3141,-114
67000340051,,4621,4571,4476,-145
67000340052,,4480,4662,4961,481
67000340053,,5954,6103,6100,146
67000340054,,3092,3033,2937,-155
67000340055,,2648,2700,2684,36
67000340056,,3886,3801,3772,-114
67000360016,,3888,3762,3714,-174
67000360017,,3220,3185,3179,-41
67000370039,,4304,4461,4691,387
67000370040,,3979,3965,3976,-3
67000370041,,3318,3355,3361,43
67000370042,,3756,3678,3645,-111
67000370043,,2316,2267,2182,-134
67000370044,,4483,4417,4365,-118
67000370045,,2835,2776,2770,-65
67000370046,,2226,2173,2111,-115
67000370047,,4547,4442,4353,-194
67000370048,,4286,4296,4279,-7
10005050033,,3488,3744,3804,316
10009010039,,2876,2904,2895,19
10009020023,,3408,3420,3454,46
10009020024,,2697,2721,2697,0
64000050001,,,,4365,0
64000050002,,,,8989,0
64000050003,,,,4534,0
64000050004,,,,4567,0
64000050005,,,,8154,0
64000050006,,,,3870,0
64000050007,,,,25397,0
64000050008,,,,9533,0
64000050009,,,,8086,0
64000050010,,,,2163,0
64000050011,,,,2021,0
64000050012,,,,6258,0
64000050013,,,,5555,0
64000050014,,,,5968,0
64000050015,,,,9331,0
64000050016,,,,3968,0
64000050017,,,,5551,0
64000050018,,,,4422,0
64000050019,,,,7356,0
64000050020,,,,3353,0
64000050021,,,,3768,0
64000050022,,,,9601,0
64000050023,,,,3670,0
64000050024,,,,3137,0
64000050025,,,,6999,0
64000050026,,,,5557,0
64000050027,,,,7892,0
64000050028,,,,4822,0
64000050029,,,,7427,0
64000050030,,,,10025,0
64000050031,,,,4315,0
64000050032,,,,3247,0
64000050033,,,,5900,0
64000050034,,,,2860,0
64000050035,,,,2025,0
64000050036,,,,3415,0
64000050037,,,,3898,0
64000050038,,,,14064,0
64000050039,,,,4524,0
64000050040,,,,2194,0
64000050041,,,,2704,0
64000050042,,,,3041,0
64000050043,,,,1997,0
64000050044,,,,5128,0
64000050045,,,,5022,0
64000050046,,,,3373,0
64000050047,,,,2719,0
64000050048,,,,1426,0
64000050049,,,,1709,0
64000050050,,,,1614,0
64000050051,,,,1019,0
64000050052,,,,2938,0
64000050053,,,,2357,0
64000050054,,,,2068,0
64000050055,,,,1538,0
64000050056,,,,851,0
64000050057,,,,1167,0
64000050058,,,,1646,0
64000050059,,,,2172,0
64000050060,,,,3462,0
64000050061,,,,4186,0
64000050062,,,,4162,0
64000050063,,,,1935,0
64000050064,,,,1930,0
64000050065,,,,2108,0
64000050066,,,,742,0
64000050067,,,,1038,0
64000050068,,,,1478,0
64000050069,,,,1602,0
64000050070,,,,840,0
64000050072,,,,1221,0
64000050073,,,,4645,0
64000050074,,,,1158,0
64000050075,,,,1278,0
64000050076,,,,2060,0
64000050077,,,,915,0
64000050078,,,,1467,0
64000050079,,,,995,0
64000050081,,,,2631,0
64000050082,,,,1329,0
64000050083,,,,1429,0
64000050084,,,,1168,0
64000050085,,,,1226,0
64000050086,,,,1296,0
64000050087,,,,1137,0
64000050088,,,,2160,0
64000120001,,,,454,0
64000120002,,,,677,0
64000120003,,,,1439,0
64000120004,,,,1057,0
64000120005,,,,1085,0
64000120006,,,,2580,0
64000120007,,,,1202,0
64000120008,,,,3812,0
64000120009,,,,11778,0
64000120010,,,,910,0
64000120011,,,,4089,0
64000120012,,,,5575,0
64000120013,,,,2795,0
64000120014,,,,7102,0
64000120015,,,,4900,0
64000120016,,,,5344,0
64000120017,,,,7715,0
64000120018,,,,6131,0
64000120019,,,,5160,0
64000120020,,,,4268,0
64000120021,,,,3669,0
64000120022,,,,3389,0
64000120024,,,,3917,0
64000120025,,,,3548,0
64000120026,,,,5476,0
64000120027,,,,7043,0
64000120028,,,,3577,0
64000120029,,,,7012,0
64000120030,,,,6245,0
64000120031,,,,5756,0
64000120032,,,,4081,0
64000120033,,,,6466,0
64000120034,,,,4078,0
64000120035,,,,7542,0
64000120036,,,,4774,0
64000120037,,,,3620,0
64000120038,,,,2712,0
64000120039,,,,10037,0
64000120040,,,,17071,0
64000120041,,,,2130,0
64000120042,,,,3998,0
64000120043,,,,3668,0
64000120044,,,,6555,0
64000120045,,,,2300,0
64000120046,,,,6066,0
64000120047,,,,3890,0
64000120048,,,,7193,0
64000120049,,,,5647,0
64000120050,,,,3001,0
64000120051,,,,1187,0
64000120053,,,,4717,0
64000120054,,,,2083,0
64000120055,,,,10448,0
64000120056,,,,10314,0
64000120057,,,,5312,0
64000120058,,,,2904,0
64000120059,,,,4677,0
64000120060,,,,11671,0
64000120061,,,,2422,0
64000120062,,,,3080,0
64000120063,,,,2892,0
64000120064,,,,2703,0
64000120065,,,,4448,0
64000120066,,,,2754,0
64000120067,,,,5148,0
64000120068,,,,4928,0
64000120069,,,,2728,0
64000120070,,,,4985,0
64000120071,,,,4937,0
64000120072,,,,5387,0
64000120073,,,,3149,0
64000120074,,,,2820,0
64000120075,,,,6200,0
64000120076,,,,3042,0
64000120077,,,,3237,0
64000120078,,,,8869,0
